Time,Charleville Mall,Charleville Mall Cyclist IN,Charleville Mall Cyclist OUT,Clontarf - James Larkin Rd,Clontarf - James Larkin Rd Cyclist IN,Clontarf - James Larkin Rd Cyclist OUT,Clontarf - Pebble Beach Carpark,Clontarf - Pebble Beach Carpark Cyclist IN,Clontarf - Pebble Beach Carpark Cyclist OUT,Drumcondra Cyclists 1,Drumcondra Cyclists 1 Cyclist IN,Drumcondra Cyclists 1 Cyclist OUT,Drumcondra Cyclists 2,Drumcondra Cyclists 2 Cyclist IN,Drumcondra Cyclists 2 Cyclist OUT,Griffith Avenue (Clare Rd Side),Griffith Avenue (Clare Rd Side) Cyclist IN,Griffith Avenue (Clare Rd Side) Cyclist OUT,Griffith Avenue (Lane Side),Griffith Avenue (Lane Side) Cyclist IN,Griffith Avenue (Lane Side) Cyclist OUT,Grove Road Totem,Grove Road Totem OUT,Grove Road Totem IN,North Strand Rd N/B,North Strand Rd S/B,Richmond Street Cyclists 1,Richmond Street Cyclists 1 Cyclist IN,Richmond Street Cyclists 1 Cyclist OUT,Richmond Street Cyclists 2 ,Richmond Street Cyclists 2  Cyclist IN,Richmond Street Cyclists 2  Cyclist OUT
1/1/2023 0:00,1,0,1,1,1,0,5,3,2,0,0,0,0,0,0,0,0,0,0,0,0,12,6,6,0,,8,0,8,2,0,2
1/1/2023 1:00,0,0,0,6,4,2,2,2,0,0,0,0,0,0,0,3,3,0,0,0,0,13,9,4,0,,6,0,6,0,0,0
1/1/2023 2:00,0,0,0,0,0,0,2,0,2,0,0,0,0,0,0,1,1,0,0,0,0,9,4,5,0,,9,0,9,3,0,3
1/1/2023 3:00,1,0,1,1,1,0,0,0,0,0,0,0,1,1,0,3,3,0,0,0,0,12,7,5,0,,8,0,8,4,1,3
1/1/2023 4:00,0,0,0,0,0,0,1,0,1,0,0,0,1,1,0,2,2,0,0,0,0,17,13,4,0,,4,0,4,4,0,4
1/1/2023 5:00,2,1,1,3,1,2,4,1,3,0,0,0,0,0,0,0,0,0,0,0,0,4,3,1,0,,9,0,9,3,0,3
1/1/2023 6:00,2,2,0,1,1,0,5,3,2,0,0,0,5,5,0,1,1,0,0,0,0,14,7,7,0,,3,0,3,7,0,7
1/1/2023 7:00,3,2,1,1,0,1,3,1,2,0,0,0,4,4,0,0,0,0,0,0,0,22,5,17,0,,4,0,4,2,0,2
1/1/2023 8:00,0,0,0,6,2,4,12,2,10,0,0,0,2,2,0,1,1,0,0,0,0,22,7,15,0,,8,1,7,7,0,7
1/1/2023 9:00,2,1,1,32,12,20,36,14,22,0,0,0,2,2,0,1,1,0,0,0,0,21,7,14,0,,7,0,7,16,0,16
1/1/2023 10:00,2,2,0,50,15,35,58,19,39,0,0,0,4,3,1,1,1,0,0,0,0,18,6,12,0,,12,0,12,11,0,11
1/1/2023 11:00,4,3,1,60,28,32,68,27,41,0,0,0,0,0,0,11,11,0,7,7,0,15,6,9,0,,10,0,10,18,0,18
1/1/2023 12:00,5,4,1,60,28,32,103,50,53,0,0,0,0,0,0,7,7,0,4,4,0,30,16,14,0,,19,0,19,24,0,24
1/1/2023 13:00,4,3,1,65,33,32,74,35,39,0,0,0,0,0,0,7,7,0,5,5,0,35,12,23,0,,21,0,21,21,0,21
1/1/2023 14:00,6,2,4,58,27,31,76,41,35,0,0,0,1,1,0,9,9,0,2,2,0,38,14,24,0,,16,0,16,24,0,24
1/1/2023 15:00,7,4,3,41,24,17,62,38,24,0,0,0,0,0,0,3,3,0,1,1,0,42,18,24,0,,27,0,27,36,1,35
1/1/2023 16:00,9,3,6,37,25,12,35,18,17,0,0,0,2,2,0,5,5,0,9,9,0,46,24,22,0,,30,0,30,33,1,32
1/1/2023 17:00,4,3,1,12,8,4,22,12,10,0,0,0,2,2,0,1,1,0,4,4,0,50,26,24,0,,38,0,38,42,1,41
1/1/2023 18:00,9,5,4,10,5,5,13,7,6,0,0,0,7,7,0,6,6,0,0,0,0,42,19,23,0,,40,0,40,47,0,47
1/1/2023 19:00,4,3,1,0,0,0,1,1,0,0,0,0,3,3,0,4,4,0,1,1,0,39,18,21,0,,36,2,34,24,0,24
1/1/2023 20:00,2,1,1,1,1,0,6,1,5,0,0,0,2,2,0,2,2,0,1,1,0,43,22,21,0,,37,0,37,38,0,38
1/1/2023 21:00,3,3,0,0,0,0,2,1,1,0,0,0,1,1,0,2,2,0,0,0,0,36,15,21,0,,25,0,25,34,1,33
1/1/2023 22:00,1,1,0,2,1,1,8,3,5,0,0,0,1,1,0,3,3,0,0,0,0,26,10,16,0,,19,0,19,24,0,24
1/1/2023 23:00,2,1,1,1,0,1,6,2,4,0,0,0,0,0,0,1,1,0,1,1,0,17,13,4,0,,12,0,12,10,0,10
2/1/2023 0:00,0,0,0,2,1,1,4,2,2,0,0,0,0,0,0,0,0,0,0,0,0,15,12,3,0,,9,0,9,5,0,5
2/1/2023 1:00,0,0,0,2,2,0,0,0,0,0,0,0,0,0,0,0,0,0,0,0,0,2,1,1,0,,1,0,1,0,0,0
2/1/2023 2:00,1,0,1,0,0,0,1,1,0,0,0,0,0,0,0,0,0,0,0,0,0,3,2,1,0,,2,0,2,1,0,1
2/1/2023 3:00,0,0,0,0,0,0,0,0,0,0,0,0,0,0,0,0,0,0,0,0,0,1,1,0,0,,0,0,0,1,0,1
2/1/2023 4:00,0,0,0,2,1,1,1,0,1,0,0,0,0,0,0,0,0,0,0,0,0,4,0,4,0,,0,0,0,0,0,0
2/1/2023 5:00,4,3,1,1,0,1,3,1,2,0,0,0,1,1,0,1,1,0,0,0,0,9,5,4,0,,3,0,3,0,0,0
2/1/2023 6:00,2,1,1,2,2,0,8,3,5,0,0,0,2,2,0,1,1,0,0,0,0,25,6,19,0,,3,0,3,7,0,7
2/1/2023 7:00,4,4,0,4,3,1,7,4,3,0,0,0,4,4,0,0,0,0,0,0,0,23,6,17,0,,12,0,12,3,0,3
2/1/2023 8:00,4,3,1,22,8,14,24,10,14,0,0,0,6,6,0,2,2,0,0,0,0,40,13,27,0,,4,0,4,3,0,3
2/1/2023 9:00,4,2,2,71,26,45,96,39,57,0,0,0,5,5,0,1,1,0,0,0,0,43,10,33,0,,9,0,9,23,0,23
2/1/2023 10:00,3,2,1,113,44,69,120,46,74,0,0,0,4,4,0,3,3,0,0,0,0,47,10,37,0,,11,0,11,27,0,27
2/1/2023 11:00,10,6,4,136,55,81,154,58,96,0,0,0,4,4,0,6,6,0,0,0,0,41,19,22,0,,28,0,28,33,0,33
2/1/2023 12:00,12,6,6,164,69,95,186,82,104,0,0,0,1,1,0,18,18,0,0,0,0,55,25,30,0,,35,0,35,59,2,57
2/1/2023 13:00,9,5,4,173,91,82,190,91,99,0,0,0,4,3,1,10,10,0,0,0,0,72,34,38,0,,39,0,39,60,2,58
2/1/2023 14:00,15,12,3,145,75,70,173,94,79,0,0,0,3,3,0,14,14,0,12,12,0,66,23,43,0,,56,0,56,61,1,60
2/1/2023 15:00,7,4,3,103,67,36,143,77,66,0,0,0,2,2,0,13,13,0,8,8,0,99,48,51,0,,49,0,49,48,1,47
2/1/2023 16:00,5,2,3,67,42,25,81,51,30,0,0,0,0,0,0,8,8,0,5,5,0,79,35,44,0,,57,1,56,53,0,53
2/1/2023 17:00,10,3,7,19,12,7,35,23,12,0,0,0,0,0,0,7,7,0,0,0,0,89,37,52,0,,59,1,58,55,2,53
2/1/2023 18:00,8,5,3,18,10,8,16,10,6,0,0,0,5,5,0,4,4,0,0,0,0,74,32,42,0,,72,1,71,54,1,53
2/1/2023 19:00,7,5,2,8,2,6,12,5,7,0,0,0,7,7,0,4,4,0,0,0,0,68,39,29,0,,47,1,46,53,0,53
2/1/2023 20:00,4,1,3,12,3,9,16,7,9,0,0,0,3,3,0,5,5,0,0,0,0,50,29,21,0,,55,0,55,41,0,41
2/1/2023 21:00,7,6,1,6,4,2,3,1,2,0,0,0,1,0,1,4,4,0,0,0,0,41,17,24,0,,44,0,44,39,0,39
2/1/2023 22:00,4,2,2,2,2,0,3,2,1,0,0,0,1,1,0,3,3,0,0,0,0,28,17,11,0,,26,0,26,17,0,17
2/1/2023 23:00,1,0,1,2,1,1,1,0,1,0,0,0,1,1,0,1,1,0,0,0,0,20,10,10,0,,15,0,15,6,0,6
3/1/2023 0:00,1,1,0,3,3,0,5,2,3,0,0,0,0,0,0,0,0,0,0,0,0,7,5,2,0,,12,0,12,7,0,7
3/1/2023 1:00,0,0,0,0,0,0,0,0,0,0,0,0,0,0,0,1,1,0,0,0,0,2,2,0,0,,2,0,2,0,0,0
3/1/2023 2:00,1,0,1,2,1,1,1,0,1,0,0,0,1,1,0,0,0,0,0,0,0,0,0,0,0,,2,0,2,1,0,1
3/1/2023 3:00,0,0,0,2,2,0,1,1,0,0,0,0,0,0,0,0,0,0,0,0,0,3,2,1,0,,2,0,2,0,0,0
3/1/2023 4:00,2,1,1,1,1,0,1,1,0,0,0,0,0,0,0,0,0,0,0,0,0,3,0,3,0,,1,0,1,0,0,0
3/1/2023 5:00,0,0,0,2,1,1,4,2,2,0,0,0,2,1,1,1,1,0,0,0,0,16,2,14,0,,2,0,2,7,0,7
3/1/2023 6:00,9,9,0,6,5,1,8,6,2,0,0,0,13,13,0,4,4,0,0,0,0,84,15,69,0,,6,0,6,14,0,14
3/1/2023 7:00,15,14,1,25,22,3,36,30,6,0,0,0,19,19,0,6,6,0,5,5,0,168,41,127,0,,14,0,14,41,1,40
3/1/2023 8:00,49,43,6,34,27,7,50,40,10,0,0,0,39,39,0,17,17,0,6,6,0,301,54,247,0,,32,0,32,93,1,92
3/1/2023 9:00,13,10,3,25,16,9,33,21,12,0,0,0,16,15,1,4,4,0,0,0,0,115,18,97,0,,18,0,18,62,0,62
3/1/2023 10:00,8,6,2,19,8,11,24,10,14,0,0,0,8,7,1,6,6,0,3,3,0,48,20,28,0,,17,0,17,28,0,28
3/1/2023 11:00,4,3,1,12,8,4,17,8,9,0,0,0,5,5,0,7,7,0,5,5,0,41,12,29,0,,31,0,31,39,0,39
3/1/2023 12:00,8,5,3,17,5,12,25,12,13,0,0,0,5,5,0,2,2,0,6,6,0,60,15,45,0,,51,0,51,55,0,55
3/1/2023 13:00,11,6,5,26,13,13,33,12,21,0,0,0,3,3,0,5,5,0,5,5,0,60,28,32,0,,53,0,53,63,1,62
3/1/2023 14:00,13,9,4,30,15,15,39,13,26,0,0,0,1,1,0,4,4,0,1,1,0,90,46,44,0,,38,0,38,54,0,54
3/1/2023 15:00,13,8,5,29,12,17,44,16,28,0,0,0,1,1,0,9,9,0,9,9,0,108,56,52,0,,63,0,63,65,0,65
3/1/2023 16:00,15,6,9,30,13,17,57,26,31,0,0,0,0,0,0,24,24,0,6,6,0,194,109,85,0,,114,2,112,52,0,52
3/1/2023 17:00,32,10,22,50,10,40,70,11,59,0,0,0,2,2,0,21,21,0,12,12,0,280,167,113,0,,154,0,154,63,0,63
3/1/2023 18:00,21,10,11,27,4,23,41,6,35,0,0,0,6,5,1,17,17,0,1,1,0,190,124,66,0,,111,0,111,87,0,87
3/1/2023 19:00,6,4,2,16,5,11,28,7,21,0,0,0,0,0,0,7,7,0,1,1,0,90,55,35,0,,77,0,77,87,1,86
3/1/2023 20:00,13,5,8,6,2,4,8,6,2,0,0,0,2,2,0,7,7,0,0,0,0,59,32,27,0,,61,0,61,61,0,61
3/1/2023 21:00,7,3,4,7,1,6,10,1,9,0,0,0,0,0,0,2,2,0,0,0,0,39,25,14,0,,47,0,47,37,0,37
3/1/2023 22:00,2,2,0,4,1,3,6,0,6,0,0,0,1,1,0,2,2,0,1,1,0,30,16,14,0,,23,0,23,15,0,15
3/1/2023 23:00,2,0,2,1,0,1,3,1,2,0,0,0,0,0,0,1,1,0,0,0,0,14,10,4,0,,16,0,16,11,0,11
4/1/2023 0:00,0,0,0,2,2,0,4,2,2,0,0,0,1,1,0,3,3,0,0,0,0,7,6,1,0,,11,0,11,8,0,8
4/1/2023 1:00,1,1,0,0,0,0,0,0,0,0,0,0,0,0,0,1,1,0,0,0,0,2,2,0,0,,2,0,2,2,0,2
4/1/2023 2:00,0,0,0,0,0,0,1,0,1,0,0,0,0,0,0,0,0,0,0,0,0,1,0,1,0,,3,0,3,1,0,1
4/1/2023 3:00,0,0,0,2,2,0,2,1,1,0,0,0,0,0,0,0,0,0,0,0,0,5,4,1,0,,3,0,3,1,0,1
4/1/2023 4:00,2,2,0,2,2,0,1,1,0,0,0,0,1,1,0,0,0,0,1,1,0,3,1,2,0,,1,0,1,1,0,1
4/1/2023 5:00,2,2,0,5,4,1,4,2,2,0,0,0,0,0,0,1,1,0,0,0,0,24,4,20,0,,2,0,2,5,0,5
4/1/2023 6:00,10,8,2,9,5,4,8,4,4,0,0,0,12,12,0,5,5,0,1,1,0,92,18,74,0,,5,0,5,20,0,20
4/1/2023 7:00,24,23,1,20,14,6,32,21,11,0,0,0,21,21,0,7,7,0,9,9,0,189,42,147,0,,25,0,25,56,0,56
4/1/2023 8:00,65,57,8,31,25,6,56,45,11,0,0,0,43,43,0,20,20,0,17,17,0,356,59,297,0,,34,0,34,134,0,134
4/1/2023 9:00,31,28,3,16,9,7,29,17,12,0,0,0,11,11,0,11,11,0,10,10,0,145,32,113,0,,21,0,21,87,0,87
4/1/2023 10:00,19,17,2,24,10,14,31,9,22,0,0,0,8,8,0,4,4,0,3,3,0,75,22,53,0,,16,0,16,44,0,44
4/1/2023 11:00,8,6,2,39,15,24,37,11,26,0,0,0,7,7,0,7,7,0,5,5,0,55,17,38,0,,34,0,34,47,1,46
4/1/2023 12:00,7,5,2,43,23,20,51,25,26,0,0,0,6,6,0,12,12,0,5,5,0,65,25,40,0,,42,0,42,65,1,64
4/1/2023 13:00,9,7,2,36,21,15,48,19,29,0,0,0,3,2,1,8,8,0,5,5,0,85,33,52,0,,46,0,46,58,1,57
4/1/2023 14:00,11,5,6,41,19,22,32,11,21,0,0,0,4,4,0,7,7,0,4,4,0,72,42,30,0,,46,0,46,58,1,57
4/1/2023 15:00,8,2,6,18,6,12,32,15,17,0,0,0,4,4,0,5,5,0,6,6,0,92,52,40,0,,58,1,57,52,1,51
4/1/2023 16:00,27,7,20,37,15,22,49,15,34,0,0,0,2,2,0,14,14,0,2,2,0,194,108,86,0,,105,0,105,49,0,49
4/1/2023 17:00,35,8,27,50,10,40,81,16,65,0,0,0,3,3,0,28,28,0,0,0,0,290,191,99,0,,161,1,160,79,0,79
4/1/2023 18:00,13,6,7,42,8,34,60,8,52,0,0,0,1,1,0,14,14,0,0,0,0,225,124,101,0,,114,0,114,81,0,81
4/1/2023 19:00,13,7,6,24,3,21,27,8,19,0,0,0,1,1,0,4,4,0,0,0,0,113,66,47,0,,70,0,70,61,0,61
4/1/2023 20:00,8,2,6,20,6,14,24,10,14,0,0,0,2,2,0,9,9,0,0,0,0,61,36,25,0,,65,0,65,52,0,52
4/1/2023 21:00,1,0,1,8,3,5,13,4,9,0,0,0,0,0,0,6,6,0,0,0,0,57,35,22,0,,61,2,59,42,2,40
4/1/2023 22:00,3,2,1,5,4,1,2,1,1,0,0,0,1,1,0,3,3,0,0,0,0,49,32,17,0,,29,0,29,28,0,28
4/1/2023 23:00,1,0,1,4,2,2,5,1,4,0,0,0,1,1,0,2,2,0,0,0,0,20,14,6,0,,22,0,22,7,0,7
5/1/2023 0:00,1,1,0,1,1,0,0,0,0,0,0,0,0,0,0,2,2,0,0,0,0,8,5,3,0,,11,0,11,1,0,1
5/1/2023 1:00,2,0,2,1,1,0,1,1,0,0,0,0,1,1,0,0,0,0,0,0,0,0,0,0,0,,1,0,1,0,0,0
5/1/2023 2:00,0,0,0,1,1,0,1,0,1,0,0,0,0,0,0,0,0,0,0,0,0,1,0,1,0,,7,0,7,0,0,0
5/1/2023 3:00,1,1,0,2,2,0,2,0,2,0,0,0,0,0,0,0,0,0,0,0,0,4,3,1,0,,3,0,3,0,0,0
5/1/2023 4:00,2,1,1,4,3,1,5,3,2,0,0,0,0,0,0,0,0,0,0,0,0,3,0,3,0,,0,0,0,1,0,1
5/1/2023 5:00,1,1,0,3,2,1,2,1,1,0,0,0,1,1,0,1,1,0,0,0,0,25,5,20,0,,2,0,2,3,0,3
5/1/2023 6:00,12,12,0,14,11,3,16,12,4,0,0,0,11,11,0,6,6,0,1,1,0,94,17,77,0,,2,0,2,14,0,14
5/1/2023 7:00,27,25,2,50,40,10,63,47,16,0,0,0,29,29,0,12,12,0,11,11,0,209,45,164,0,,27,0,27,53,0,53
5/1/2023 8:00,81,69,12,58,46,12,97,78,19,0,0,0,40,40,0,38,38,0,74,74,0,477,81,396,0,,46,0,46,152,0,152
5/1/2023 9:00,25,22,3,35,25,10,54,38,16,0,0,0,19,19,0,16,16,0,9,9,0,178,34,144,0,,23,0,23,95,0,95
5/1/2023 10:00,11,11,0,31,20,11,37,14,23,0,0,0,9,8,1,3,3,0,5,5,0,76,30,46,0,,31,0,31,38,0,38
5/1/2023 11:00,12,8,4,46,21,25,53,25,28,0,0,0,4,3,1,9,9,0,0,0,0,81,22,59,0,,24,0,24,47,0,47
5/1/2023 12:00,10,8,2,38,18,20,54,25,29,0,0,0,3,3,0,5,5,0,0,0,0,74,34,40,0,,82,0,82,67,0,67
5/1/2023 13:00,7,5,2,29,14,15,43,20,23,0,0,0,1,1,0,13,13,0,0,0,0,98,46,52,0,,52,0,52,83,0,83
5/1/2023 14:00,8,4,4,29,11,18,39,16,23,0,0,0,2,2,0,6,6,0,0,0,0,84,43,41,0,,63,0,63,74,0,74
5/1/2023 15:00,15,10,5,22,3,19,33,8,25,0,0,0,3,3,0,49,49,0,10,10,0,116,74,42,0,,73,0,73,76,0,76
5/1/2023 16:00,30,14,16,30,12,18,35,7,28,0,0,0,1,1,0,30,30,0,4,4,0,179,114,65,0,,98,0,98,56,0,56
5/1/2023 17:00,50,17,33,58,4,54,82,8,74,0,0,0,0,0,0,30,30,0,1,1,0,293,195,98,0,,181,1,180,78,0,78
5/1/2023 18:00,17,6,11,37,7,30,67,10,57,0,0,0,2,2,0,22,22,0,3,3,0,249,177,72,0,,126,0,126,66,1,65
5/1/2023 19:00,10,4,6,24,5,19,33,8,25,0,0,0,3,3,0,11,11,0,5,5,0,125,81,44,0,,68,0,68,74,0,74
5/1/2023 20:00,8,5,3,14,4,10,19,7,12,0,0,0,2,2,0,10,10,0,7,7,0,70,39,31,0,,61,0,61,64,0,64
5/1/2023 21:00,3,2,1,8,4,4,12,1,11,0,0,0,2,2,0,9,9,0,3,3,0,41,26,15,0,,53,0,53,40,0,40
5/1/2023 22:00,8,3,5,3,1,2,9,2,7,0,0,0,1,1,0,4,4,0,2,2,0,39,23,16,0,,43,0,43,23,0,23
5/1/2023 23:00,1,1,0,4,0,4,6,0,6,0,0,0,0,0,0,5,5,0,0,0,0,21,15,6,0,,25,0,25,12,0,12
6/1/2023 0:00,1,1,0,3,2,1,3,2,1,0,0,0,1,1,0,1,1,0,0,0,0,8,4,4,0,,12,0,12,5,0,5
6/1/2023 1:00,0,0,0,0,0,0,1,0,1,0,0,0,1,1,0,0,0,0,0,0,0,4,3,1,0,,1,0,1,0,0,0
6/1/2023 2:00,1,0,1,0,0,0,3,1,2,0,0,0,0,0,0,0,0,0,0,0,0,1,1,0,0,,2,0,2,2,0,2
6/1/2023 3:00,1,0,1,1,1,0,2,1,1,0,0,0,0,0,0,0,0,0,0,0,0,3,2,1,0,,1,1,0,2,0,2
6/1/2023 4:00,2,2,0,1,1,0,2,0,2,0,0,0,0,0,0,0,0,0,0,0,0,7,3,4,0,,3,0,3,0,0,0
6/1/2023 5:00,1,0,1,3,2,1,3,2,1,0,0,0,2,2,0,1,1,0,0,0,0,21,2,19,0,,1,0,1,8,0,8
6/1/2023 6:00,13,12,1,10,7,3,13,9,4,0,0,0,8,8,0,9,9,0,1,1,0,84,15,69,0,,4,0,4,16,0,16
6/1/2023 7:00,18,17,1,31,23,8,41,34,7,0,0,0,13,13,0,10,10,0,0,0,0,183,43,140,0,,24,0,24,51,0,51
6/1/2023 8:00,60,54,6,61,47,14,76,62,14,0,0,0,44,44,0,41,41,0,0,0,0,336,63,273,0,,31,1,30,87,0,87
6/1/2023 9:00,22,18,4,33,22,11,43,25,18,0,0,0,18,18,0,6,6,0,0,0,0,154,31,123,0,,22,0,22,95,1,94
6/1/2023 10:00,8,7,1,48,23,25,50,15,35,0,0,0,9,8,1,6,6,0,0,0,0,48,18,30,0,,22,1,21,34,0,34
6/1/2023 11:00,14,11,3,52,23,29,60,22,38,0,0,0,8,8,0,1,1,0,0,0,0,72,25,47,0,,26,0,26,68,0,68
6/1/2023 12:00,9,6,3,66,36,30,83,37,46,0,0,0,3,3,0,16,16,0,0,0,0,33,33,0,0,,56,0,56,85,0,85
6/1/2023 13:00,9,6,3,54,25,29,78,39,39,0,0,0,3,3,0,32,32,0,5,5,0,96,46,50,0,,65,0,65,66,0,66
6/1/2023 14:00,9,5,4,49,20,29,53,23,30,0,0,0,6,6,0,20,20,0,11,11,0,95,52,43,0,,65,0,65,60,0,60
6/1/2023 15:00,14,5,9,46,21,25,60,23,37,0,0,0,2,2,0,25,25,0,10,10,0,140,78,62,0,,69,0,69,77,0,77
6/1/2023 16:00,24,9,15,46,17,29,68,27,41,0,0,0,1,1,0,23,23,0,1,1,0,185,101,84,0,,112,0,112,66,1,65
6/1/2023 17:00,25,9,16,46,13,33,64,14,50,0,0,0,8,8,0,28,28,0,1,1,0,238,163,75,0,,150,0,150,81,0,81
6/1/2023 18:00,12,9,3,43,13,30,61,17,44,0,0,0,6,6,0,13,13,0,10,10,0,159,93,66,0,,95,0,95,88,1,87
6/1/2023 19:00,11,5,6,17,6,11,28,11,17,0,0,0,5,5,0,7,7,0,3,3,0,115,72,43,0,,111,1,110,62,0,62
6/1/2023 20:00,9,7,2,10,5,5,16,5,11,0,0,0,4,4,0,5,5,0,1,1,0,97,57,40,0,,63,0,63,72,0,72
6/1/2023 21:00,8,6,2,8,4,4,11,4,7,0,0,0,2,2,0,6,6,0,2,2,0,58,35,23,0,,49,0,49,61,0,61
6/1/2023 22:00,8,7,1,2,1,1,3,0,3,0,0,0,0,0,0,1,1,0,0,0,0,42,24,18,0,,34,0,34,33,0,33
6/1/2023 23:00,3,2,1,3,0,3,5,0,5,0,0,0,2,2,0,0,0,0,0,0,0,27,14,13,0,,22,2,20,13,0,13
7/1/2023 0:00,0,0,0,0,0,0,3,1,2,0,0,0,1,1,0,2,2,0,0,0,0,16,9,7,0,,24,0,24,9,0,9
7/1/2023 1:00,2,1,1,0,0,0,2,1,1,0,0,0,2,2,0,0,0,0,0,0,0,15,9,6,0,,8,0,8,0,0,0
7/1/2023 2:00,1,1,0,1,1,0,2,1,1,0,0,0,0,0,0,1,1,0,0,0,0,10,7,3,0,,13,0,13,5,0,5
7/1/2023 3:00,0,0,0,0,0,0,2,1,1,0,0,0,0,0,0,0,0,0,0,0,0,8,5,3,0,,7,1,6,5,0,5
7/1/2023 4:00,1,0,1,0,0,0,0,0,0,0,0,0,1,1,0,0,0,0,0,0,0,6,6,0,0,,5,0,5,2,0,2
7/1/2023 5:00,1,0,1,0,0,0,2,0,2,0,0,0,1,1,0,0,0,0,0,0,0,5,1,4,0,,3,0,3,1,0,1
7/1/2023 6:00,3,2,1,2,2,0,2,2,0,0,0,0,3,3,0,3,3,0,2,2,0,15,3,12,0,,2,0,2,6,0,6
7/1/2023 7:00,4,3,1,9,3,6,14,4,10,0,0,0,6,6,0,2,2,0,0,0,0,37,12,25,0,,7,0,7,13,0,13
7/1/2023 8:00,4,4,0,52,25,27,59,24,35,0,0,0,8,8,0,5,5,0,1,1,0,57,13,44,0,,7,0,7,15,0,15
7/1/2023 9:00,16,13,3,76,38,38,86,34,52,0,0,0,12,12,0,8,8,0,0,0,0,60,19,41,0,,16,0,16,35,1,34
7/1/2023 10:00,9,7,2,98,46,52,96,44,52,0,0,0,6,6,0,14,14,0,0,0,0,55,20,35,0,,26,0,26,55,0,55
7/1/2023 11:00,6,3,3,93,41,52,124,58,66,0,0,0,2,2,0,11,11,0,2,2,0,70,25,45,0,,37,0,37,78,0,78
7/1/2023 12:00,14,9,5,77,39,38,95,44,51,0,0,0,1,1,0,10,10,0,0,0,0,87,36,51,0,,43,0,43,72,0,72
7/1/2023 13:00,8,5,3,77,43,34,105,50,55,0,0,0,2,2,0,14,14,0,0,0,0,97,41,56,0,,68,0,68,67,0,67
7/1/2023 14:00,11,7,4,83,46,37,95,41,54,0,0,0,7,7,0,14,14,0,0,0,0,98,51,47,0,,57,0,57,60,0,60
7/1/2023 15:00,19,9,10,63,25,38,78,40,38,0,0,0,11,11,0,12,12,0,0,0,0,73,32,41,0,,60,2,58,77,2,75
7/1/2023 16:00,11,7,4,36,20,16,42,24,18,0,0,0,13,12,1,14,14,0,0,0,0,99,47,52,0,,68,0,68,69,0,69
7/1/2023 17:00,12,7,5,19,8,11,31,13,18,0,0,0,5,4,1,8,8,0,5,5,0,81,34,47,0,,56,0,56,58,0,58
7/1/2023 18:00,3,3,0,4,2,2,12,7,5,0,0,0,3,3,0,2,2,0,0,0,0,74,38,36,0,,68,1,67,61,1,60
7/1/2023 19:00,6,1,5,5,1,4,10,3,7,0,0,0,3,3,0,3,3,0,0,0,0,79,37,42,0,,73,1,72,100,0,100
7/1/2023 20:00,4,1,3,4,1,3,4,1,3,0,0,0,3,3,0,6,6,0,0,0,0,58,23,35,0,,50,0,50,86,1,85
7/1/2023 21:00,4,4,0,2,0,2,5,1,4,0,0,0,2,2,0,3,3,0,0,0,0,36,17,19,0,,32,0,32,46,1,45
7/1/2023 22:00,11,9,2,2,2,0,4,2,2,0,0,0,3,3,0,2,2,0,0,0,0,24,12,12,0,,26,0,26,24,1,23
7/1/2023 23:00,2,1,1,0,0,0,4,1,3,0,0,0,2,2,0,1,1,0,0,0,0,21,15,6,0,,16,0,16,13,0,13
8/1/2023 0:00,3,3,0,1,1,0,1,0,1,0,0,0,0,0,0,1,1,0,1,1,0,12,9,3,0,,20,0,20,19,0,19
8/1/2023 1:00,0,0,0,4,4,0,0,0,0,0,0,0,0,0,0,2,2,0,1,1,0,11,10,1,0,,2,0,2,0,0,0
8/1/2023 2:00,0,0,0,0,0,0,0,0,0,0,0,0,0,0,0,0,0,0,0,0,0,5,5,0,0,,11,0,11,6,0,6
8/1/2023 3:00,0,0,0,0,0,0,0,0,0,0,0,0,0,0,0,2,2,0,0,0,0,10,8,2,0,,7,1,6,3,0,3
8/1/2023 4:00,1,0,1,0,0,0,0,0,0,0,0,0,1,1,0,0,0,0,0,0,0,6,5,1,0,,3,0,3,3,0,3
8/1/2023 5:00,1,1,0,0,0,0,1,0,1,0,0,0,0,0,0,0,0,0,0,0,0,10,4,6,0,,4,0,4,1,0,1
8/1/2023 6:00,1,1,0,1,1,0,3,1,2,0,0,0,1,1,0,1,1,0,0,0,0,18,6,12,0,,2,0,2,4,0,4
8/1/2023 7:00,0,0,0,8,3,5,7,3,4,0,0,0,6,6,0,1,1,0,1,1,0,22,4,18,0,,6,0,6,7,0,7
8/1/2023 8:00,4,4,0,42,19,23,54,18,36,0,0,0,8,7,1,4,4,0,3,3,0,27,8,19,0,,6,0,6,8,0,8
8/1/2023 9:00,5,4,1,95,33,62,112,48,64,0,0,0,5,5,0,26,26,0,11,11,0,37,14,23,0,,10,1,9,20,0,20
8/1/2023 10:00,4,4,0,136,54,82,155,53,102,0,0,0,4,4,0,7,7,0,8,8,0,56,11,45,0,,21,0,21,31,0,31
8/1/2023 11:00,11,7,4,126,67,59,150,67,83,0,0,0,7,6,1,8,8,0,9,9,0,91,30,61,0,,30,0,30,33,0,33
8/1/2023 12:00,12,9,3,137,68,69,193,94,99,0,0,0,6,6,0,8,8,0,5,5,0,81,35,46,0,,45,0,45,52,0,52
8/1/2023 13:00,11,4,7,54,26,28,87,45,42,0,0,0,4,4,0,4,4,0,0,0,0,72,34,38,0,,30,0,30,74,0,74
8/1/2023 14:00,12,9,3,66,31,35,79,30,49,0,0,0,3,3,0,11,11,0,1,1,0,93,35,58,0,,40,0,40,69,1,68
8/1/2023 15:00,6,2,4,59,29,30,86,50,36,0,0,0,2,2,0,18,18,0,2,2,0,65,36,29,0,,43,0,43,58,1,57
8/1/2023 16:00,7,5,2,52,37,15,55,36,19,0,0,0,2,2,0,7,7,0,11,11,0,61,21,40,0,,67,0,67,50,0,50
8/1/2023 17:00,15,8,7,18,7,11,35,20,15,0,0,0,0,0,0,7,7,0,6,6,0,95,38,57,0,,81,0,81,71,1,70
8/1/2023 18:00,10,7,3,5,3,2,8,4,4,0,0,0,6,6,0,4,4,0,1,1,0,88,37,51,0,,50,2,48,59,1,58
8/1/2023 19:00,7,4,3,17,6,11,20,7,13,0,0,0,5,5,0,9,9,0,0,0,0,70,36,34,0,,57,0,57,71,0,71
8/1/2023 20:00,1,0,1,8,5,3,11,7,4,0,0,0,4,4,0,3,3,0,0,0,0,54,27,27,0,,32,0,32,51,0,51
8/1/2023 21:00,9,4,5,9,5,4,9,3,6,0,0,0,0,0,0,4,4,0,0,0,0,37,17,20,0,,33,1,32,41,0,41
8/1/2023 22:00,5,3,2,1,1,0,2,2,0,0,0,0,1,1,0,1,1,0,0,0,0,26,17,9,0,,25,1,24,17,2,15
8/1/2023 23:00,4,3,1,0,0,0,2,0,2,0,0,0,1,1,0,1,1,0,0,0,0,19,14,5,0,,14,0,14,8,0,8
9/1/2023 0:00,1,0,1,1,0,1,1,1,0,0,0,0,0,0,0,0,0,0,0,0,0,13,11,2,0,,11,0,11,5,0,5
9/1/2023 1:00,3,2,1,2,2,0,0,0,0,0,0,0,0,0,0,0,0,0,0,0,0,2,2,0,0,,3,0,3,0,0,0
9/1/2023 2:00,0,0,0,0,0,0,1,0,1,0,0,0,0,0,0,0,0,0,0,0,0,4,3,1,0,,4,0,4,0,0,0
9/1/2023 3:00,0,0,0,1,1,0,2,1,1,0,0,0,0,0,0,0,0,0,0,0,0,2,0,2,0,,1,0,1,1,0,1
9/1/2023 4:00,1,1,0,2,2,0,2,2,0,0,0,0,0,0,0,0,0,0,1,1,0,4,2,2,0,,3,0,3,0,0,0
9/1/2023 5:00,1,1,0,2,2,0,2,2,0,0,0,0,0,0,0,1,1,0,0,0,0,39,6,33,0,,3,0,3,5,0,5
9/1/2023 6:00,10,10,0,9,6,3,12,8,4,0,0,0,15,15,0,5,5,0,0,0,0,99,23,76,0,,4,0,4,21,0,21
9/1/2023 7:00,35,30,5,45,38,7,51,44,7,0,0,0,34,34,0,9,9,0,10,10,0,262,60,202,0,,33,1,32,51,0,51
9/1/2023 8:00,86,73,13,66,51,15,87,70,17,0,0,0,57,57,0,47,47,0,47,47,0,510,90,420,0,,51,0,51,165,2,163
9/1/2023 9:00,42,37,5,26,17,9,27,18,9,0,0,0,29,29,0,11,11,0,2,2,0,193,32,161,0,,29,0,29,108,0,108
9/1/2023 10:00,10,10,0,27,13,14,22,8,14,0,0,0,8,8,0,5,5,0,2,2,0,71,25,46,0,,21,0,21,39,1,38
9/1/2023 11:00,5,3,2,30,14,16,28,7,21,0,0,0,1,1,0,5,5,0,0,0,0,53,18,35,0,,29,0,29,45,0,45
9/1/2023 12:00,7,5,2,24,10,14,27,10,17,0,0,0,0,0,0,6,6,0,2,2,0,80,18,62,0,,41,1,40,64,0,64
9/1/2023 13:00,14,11,3,32,12,20,38,13,25,0,0,0,0,0,0,10,10,0,2,2,0,98,39,59,0,,52,0,52,76,1,75
9/1/2023 14:00,14,9,5,17,5,12,33,11,22,0,0,0,4,4,0,13,13,0,9,9,0,85,42,43,0,,43,0,43,63,0,63
9/1/2023 15:00,20,7,13,17,6,11,31,10,21,0,0,0,0,0,0,47,47,0,2,2,0,118,71,47,0,,66,0,66,59,0,59
9/1/2023 16:00,32,10,22,43,15,28,56,12,44,0,0,0,0,0,0,33,33,0,0,0,0,196,117,79,0,,107,1,106,46,0,46
9/1/2023 17:00,45,10,35,58,11,47,94,15,79,0,0,0,0,0,0,47,47,0,0,0,0,361,252,109,0,,208,1,207,101,0,101
9/1/2023 18:00,29,10,19,62,11,51,80,14,66,0,0,0,4,4,0,21,21,0,0,0,0,277,189,88,0,,169,0,169,95,0,95
9/1/2023 19:00,13,6,7,25,5,20,29,9,20,0,0,0,3,3,0,15,15,0,0,0,0,133,101,32,0,,124,0,124,65,1,64
9/1/2023 20:00,10,2,8,24,11,13,20,6,14,0,0,0,1,1,0,7,7,0,0,0,0,89,58,31,0,,65,0,65,57,0,57
9/1/2023 21:00,2,1,1,14,7,7,19,6,13,0,0,0,1,1,0,9,9,0,0,0,0,55,30,25,0,,42,0,42,26,0,26
9/1/2023 22:00,6,4,2,6,1,5,7,2,5,0,0,0,2,2,0,8,8,0,4,4,0,40,28,12,0,,26,0,26,16,0,16
9/1/2023 23:00,0,0,0,2,1,1,3,1,2,0,0,0,0,0,0,1,1,0,1,1,0,19,14,5,0,,17,0,17,7,0,7
10/1/2023 0:00,1,1,0,2,2,0,5,3,2,0,0,0,0,0,0,2,2,0,0,0,0,12,10,2,0,,8,0,8,3,0,3
10/1/2023 1:00,2,1,1,0,0,0,1,0,1,0,0,0,1,1,0,0,0,0,0,0,0,1,1,0,0,,1,0,1,0,0,0
10/1/2023 2:00,0,0,0,0,0,0,0,0,0,0,0,0,0,0,0,0,0,0,0,0,0,1,1,0,0,,1,0,1,1,0,1
10/1/2023 3:00,1,0,1,0,0,0,0,0,0,0,0,0,0,0,0,0,0,0,0,0,0,1,0,1,0,,0,0,0,1,0,1
10/1/2023 4:00,1,1,0,1,1,0,1,0,1,0,0,0,1,1,0,0,0,0,0,0,0,3,0,3,0,,2,0,2,0,0,0
10/1/2023 5:00,1,1,0,0,0,0,1,1,0,0,0,0,0,0,0,2,2,0,0,0,0,26,4,22,0,,1,0,1,7,0,7
10/1/2023 6:00,16,14,2,7,7,0,6,6,0,0,0,0,9,9,0,6,6,0,0,0,0,88,18,70,0,,7,0,7,10,0,10
10/1/2023 7:00,29,27,2,38,32,6,46,39,7,0,0,0,21,21,0,13,13,0,1,1,0,239,50,189,0,,25,0,25,53,0,53
10/1/2023 8:00,98,89,9,64,54,10,87,75,12,0,0,0,57,57,0,36,36,0,28,28,0,547,86,461,0,,42,2,40,172,1,171
10/1/2023 9:00,43,36,7,19,15,4,34,27,7,0,0,0,29,29,0,16,16,0,6,6,0,195,30,165,0,,26,1,25,107,1,106
10/1/2023 10:00,13,10,3,17,8,9,24,10,14,0,0,0,12,12,0,5,5,0,3,3,0,64,17,47,0,,27,0,27,42,0,42
10/1/2023 11:00,2,2,0,21,7,14,23,10,13,0,0,0,5,5,0,9,9,0,5,5,0,53,22,31,0,,22,0,22,41,0,41
10/1/2023 12:00,10,8,2,11,6,5,24,12,12,0,0,0,6,6,0,7,7,0,1,1,0,69,26,43,0,,51,1,50,74,0,74
10/1/2023 13:00,10,5,5,24,10,14,30,13,17,0,0,0,4,4,0,9,9,0,2,2,0,72,28,44,0,,51,0,51,58,0,58
10/1/2023 14:00,10,3,7,13,4,9,13,4,9,0,0,0,3,3,0,11,11,0,8,8,0,76,38,38,0,,58,1,57,45,0,45
10/1/2023 15:00,13,5,8,17,7,10,17,7,10,0,0,0,4,4,0,35,35,0,5,5,0,110,50,60,0,,40,0,40,29,0,29
10/1/2023 16:00,29,10,19,23,4,19,34,4,30,0,0,0,2,2,0,23,23,0,2,2,0,154,87,67,0,,70,0,70,49,0,49
10/1/2023 17:00,57,13,44,60,9,51,80,11,69,0,0,0,1,1,0,31,31,0,2,2,0,330,220,110,0,,202,1,201,94,0,94
10/1/2023 18:00,32,12,20,54,9,45,82,10,72,0,0,0,2,2,0,28,28,0,1,1,0,286,200,86,0,,158,1,157,84,0,84
10/1/2023 19:00,10,6,4,26,8,18,29,5,24,0,0,0,2,2,0,12,12,0,9,9,0,166,101,65,0,,98,0,98,60,0,60
10/1/2023 20:00,6,1,5,11,5,6,21,8,13,0,0,0,0,0,0,6,6,0,0,0,0,105,71,34,0,,82,0,82,60,1,59
10/1/2023 21:00,6,3,3,6,3,3,8,1,7,0,0,0,1,1,0,7,7,0,0,0,0,47,35,12,0,,35,0,35,43,0,43
10/1/2023 22:00,4,2,2,4,2,2,8,3,5,0,0,0,0,0,0,2,2,0,0,0,0,32,19,13,0,,34,0,34,23,0,23
10/1/2023 23:00,1,1,0,2,1,1,2,0,2,0,0,0,1,1,0,1,1,0,2,2,0,20,12,8,0,,20,1,19,12,0,12
11/1/2023 0:00,1,1,0,3,3,0,5,4,1,0,0,0,0,0,0,1,1,0,0,0,0,11,10,1,0,,7,0,7,4,0,4
11/1/2023 1:00,1,0,1,0,0,0,0,0,0,0,0,0,0,0,0,0,0,0,0,0,0,1,1,0,0,,1,0,1,3,0,3
11/1/2023 2:00,0,0,0,1,0,1,1,0,1,0,0,0,0,0,0,0,0,0,0,0,0,3,1,2,0,,2,0,2,1,0,1
11/1/2023 3:00,0,0,0,1,1,0,2,0,2,0,0,0,0,0,0,0,0,0,1,1,0,2,1,1,0,,1,0,1,1,0,1
11/1/2023 4:00,2,1,1,1,1,0,0,0,0,0,0,0,2,2,0,0,0,0,1,1,0,5,2,3,0,,2,0,2,0,0,0
11/1/2023 5:00,2,1,1,4,3,1,5,3,2,0,0,0,1,1,0,1,1,0,0,0,0,22,1,21,0,,2,0,2,7,0,7
11/1/2023 6:00,12,11,1,9,6,3,10,7,3,0,0,0,12,12,0,6,6,0,5,5,0,106,20,86,0,,9,0,9,21,0,21
11/1/2023 7:00,29,27,2,23,21,2,33,27,6,0,0,0,26,26,0,11,11,0,10,10,0,274,65,209,0,,34,0,34,47,0,47
11/1/2023 8:00,108,92,16,57,50,7,87,75,12,0,0,0,57,57,0,50,50,0,116,116,0,583,85,498,0,,51,1,50,122,1,121
11/1/2023 9:00,50,42,8,28,19,9,43,31,12,0,0,0,43,42,1,20,20,0,5,5,0,197,37,160,0,,15,1,14,69,0,69
11/1/2023 10:00,9,7,2,11,7,4,16,10,6,0,0,0,10,10,0,4,4,0,5,5,0,62,18,44,0,,20,0,20,38,0,38
11/1/2023 11:00,5,3,2,11,6,5,11,7,4,0,0,0,3,3,0,5,5,0,1,1,0,65,19,46,0,,19,0,19,40,0,40
11/1/2023 12:00,12,7,5,22,6,16,20,5,15,0,0,0,7,7,0,6,6,0,3,3,0,59,21,38,0,,53,0,53,60,0,60
11/1/2023 13:00,20,6,14,23,9,14,24,5,19,0,0,0,3,3,0,14,14,0,9,9,0,101,49,52,0,,56,1,55,62,0,62
11/1/2023 14:00,14,10,4,29,13,16,29,9,20,0,0,0,1,1,0,20,20,0,11,11,0,82,32,50,0,,53,1,52,43,0,43
11/1/2023 15:00,14,6,8,15,5,10,24,7,17,0,0,0,7,7,0,28,28,0,13,13,0,107,64,43,0,,65,0,65,50,0,50
11/1/2023 16:00,30,9,21,38,13,25,41,7,34,0,0,0,2,2,0,27,27,0,8,8,0,231,155,76,0,,95,0,95,48,0,48
11/1/2023 17:00,55,12,43,58,7,51,75,11,64,0,0,0,2,1,1,25,25,0,19,19,0,373,262,111,0,,209,1,208,97,0,97
11/1/2023 18:00,29,7,22,51,5,46,77,6,71,0,0,0,2,2,0,27,27,0,6,6,0,291,214,77,0,,173,0,173,69,0,69
11/1/2023 19:00,16,4,12,17,4,13,34,9,25,0,0,0,1,1,0,15,15,0,2,2,0,173,108,65,0,,112,0,112,76,0,76
11/1/2023 20:00,7,6,1,10,1,9,14,3,11,0,0,0,0,0,0,8,8,0,0,0,0,100,63,37,0,,61,0,61,49,0,49
11/1/2023 21:00,2,2,0,6,3,3,11,3,8,0,0,0,0,0,0,9,9,0,1,1,0,52,34,18,0,,43,0,43,31,0,31
11/1/2023 22:00,11,4,7,1,1,0,2,0,2,0,0,0,0,0,0,1,1,0,2,2,0,35,20,15,0,,36,0,36,15,2,13
11/1/2023 23:00,3,2,1,1,0,1,3,0,3,0,0,0,0,0,0,4,4,0,1,1,0,17,12,5,0,,25,0,25,10,0,10
12/1/2023 0:00,0,0,0,3,1,2,4,0,4,0,0,0,1,1,0,2,2,0,0,0,0,9,7,2,0,,9,0,9,10,0,10
12/1/2023 1:00,0,0,0,0,0,0,0,0,0,0,0,0,0,0,0,0,0,0,0,0,0,2,1,1,0,,3,0,3,0,0,0
12/1/2023 2:00,1,0,1,0,0,0,0,0,0,0,0,0,0,0,0,0,0,0,0,0,0,1,0,1,0,,0,0,0,3,0,3
12/1/2023 3:00,0,0,0,1,1,0,1,1,0,0,0,0,0,0,0,0,0,0,0,0,0,2,1,1,0,,3,0,3,1,0,1
12/1/2023 4:00,0,0,0,0,0,0,0,0,0,0,0,0,2,2,0,0,0,0,1,1,0,3,0,3,0,,3,0,3,2,1,1
12/1/2023 5:00,2,2,0,2,1,1,2,1,1,0,0,0,1,1,0,2,2,0,2,2,0,20,1,19,0,,4,0,4,2,0,2
12/1/2023 6:00,9,8,1,9,5,4,14,9,5,0,0,0,7,7,0,6,6,0,2,2,0,90,21,69,0,,10,0,10,21,0,21
12/1/2023 7:00,31,30,1,38,31,7,46,40,6,0,0,0,23,23,0,11,11,0,16,16,0,251,57,194,0,,21,0,21,47,0,47
12/1/2023 8:00,104,92,12,47,38,9,68,56,12,0,0,0,60,60,0,39,39,0,119,119,0,557,90,467,0,,64,0,64,185,0,185
12/1/2023 9:00,41,32,9,23,19,4,29,24,5,0,0,0,27,27,0,12,12,0,10,10,0,216,39,177,0,,21,0,21,110,1,109
12/1/2023 10:00,16,16,0,5,2,3,6,0,6,0,0,0,4,4,0,3,3,0,3,3,0,61,23,38,0,,16,0,16,38,0,38
12/1/2023 11:00,3,3,0,7,1,6,14,5,9,0,0,0,2,2,0,6,6,0,3,3,0,65,16,49,0,,15,0,15,43,0,43
12/1/2023 12:00,17,10,7,7,1,6,14,4,10,0,0,0,0,0,0,3,3,0,4,4,0,89,35,54,0,,49,0,49,66,1,65
12/1/2023 13:00,14,6,8,11,6,5,24,6,18,0,0,0,6,6,0,11,11,0,13,13,0,98,43,55,0,,62,0,62,58,0,58
12/1/2023 14:00,10,5,5,15,5,10,19,7,12,0,0,0,0,0,0,10,10,0,15,15,0,88,37,51,0,,43,0,43,55,0,55
12/1/2023 15:00,21,10,11,9,2,7,17,5,12,0,0,0,0,0,0,41,41,0,5,5,0,115,67,48,0,,45,0,45,39,0,39
12/1/2023 16:00,33,9,24,23,5,18,34,3,31,0,0,0,0,0,0,15,15,0,8,8,0,202,121,81,0,,86,0,86,59,0,59
12/1/2023 17:00,52,15,37,32,4,28,62,7,55,0,0,0,1,1,0,28,28,0,6,6,0,314,211,103,0,,200,1,199,72,0,72
12/1/2023 18:00,28,8,20,46,8,38,69,10,59,0,0,0,0,0,0,22,22,0,6,6,0,251,155,96,0,,172,1,171,79,1,78
12/1/2023 19:00,11,4,7,12,2,10,28,7,21,0,0,0,1,1,0,13,13,0,8,8,0,134,86,48,0,,88,0,88,66,0,66
12/1/2023 20:00,10,5,5,10,5,5,8,3,5,0,0,0,0,0,0,9,9,0,7,7,0,98,62,36,0,,68,0,68,69,2,67
12/1/2023 21:00,7,3,4,3,1,2,10,1,9,0,0,0,0,0,0,9,9,0,5,5,0,42,29,13,0,,41,0,41,42,1,41
12/1/2023 22:00,5,5,0,3,1,2,6,0,6,0,0,0,2,2,0,6,6,0,0,0,0,33,17,16,0,,38,0,38,15,0,15
12/1/2023 23:00,4,2,2,4,2,2,4,1,3,0,0,0,0,0,0,1,1,0,0,0,0,25,15,10,0,,25,1,24,18,0,18
13/01/2023 00:00,2,0,2,0,0,0,2,0,2,0,0,0,0,0,0,0,0,0,0,0,0,10,9,1,0,,13,0,13,8,0,8
13/01/2023 01:00,0,0,0,0,0,0,0,0,0,0,0,0,0,0,0,0,0,0,0,0,0,4,4,0,0,,1,0,1,0,0,0
13/01/2023 02:00,0,0,0,0,0,0,0,0,0,0,0,0,0,0,0,0,0,0,0,0,0,0,0,0,0,,1,0,1,1,0,1
13/01/2023 03:00,0,0,0,0,0,0,0,0,0,0,0,0,0,0,0,1,1,0,0,0,0,1,0,1,0,,8,0,8,1,0,1
13/01/2023 04:00,2,2,0,0,0,0,2,0,2,0,0,0,2,2,0,0,0,0,1,1,0,5,2,3,0,,0,0,0,0,0,0
13/01/2023 05:00,0,0,0,2,2,0,2,1,1,0,0,0,1,1,0,0,0,0,0,0,0,18,0,18,0,,1,0,1,8,0,8
13/01/2023 06:00,13,12,1,1,1,0,7,7,0,0,0,0,7,7,0,7,7,0,1,1,0,80,14,66,0,,6,0,6,20,0,20
13/01/2023 07:00,18,17,1,12,10,2,19,14,5,0,0,0,16,16,0,11,11,0,11,11,0,171,39,132,0,,23,0,23,42,0,42
13/01/2023 08:00,58,48,10,32,25,7,33,25,8,0,0,0,43,43,0,28,28,0,75,75,0,327,57,270,0,,34,1,33,109,0,109
13/01/2023 09:00,22,17,5,18,13,5,20,15,5,0,0,0,24,24,0,11,11,0,0,0,0,153,23,130,0,,36,0,36,83,0,83
13/01/2023 10:00,6,6,0,21,11,10,27,9,18,0,0,0,1,1,0,15,15,0,0,0,0,28,14,14,0,,20,1,19,47,0,47
13/01/2023 11:00,14,10,4,19,8,11,24,7,17,0,0,0,3,3,0,13,13,0,0,0,0,27,18,9,0,,22,0,22,45,0,45
13/01/2023 12:00,10,5,5,23,10,13,27,8,19,0,0,0,7,7,0,12,12,0,2,2,0,90,33,57,0,,56,1,55,57,1,56
13/01/2023 13:00,11,5,6,29,11,18,26,12,14,0,0,0,4,4,0,28,28,0,0,0,0,123,59,64,0,,72,1,71,57,0,57
13/01/2023 14:00,16,8,8,35,14,21,29,7,22,0,0,0,3,3,0,21,21,0,0,0,0,92,45,47,0,,64,0,64,61,0,61
13/01/2023 15:00,16,6,10,25,10,15,43,19,24,0,0,0,6,6,0,24,24,0,0,0,0,120,65,55,0,,73,0,73,62,0,62
13/01/2023 16:00,21,9,12,35,12,23,51,18,33,0,0,0,0,0,0,23,23,0,2,2,0,177,96,81,0,,73,0,73,55,0,55
13/01/2023 17:00,36,15,21,37,8,29,53,9,44,0,0,0,2,2,0,34,34,0,8,8,0,256,162,94,0,,133,1,132,83,1,82
13/01/2023 18:00,17,6,11,39,10,29,45,11,34,0,0,0,4,4,0,14,14,0,1,1,0,210,125,85,0,,134,1,133,68,0,68
13/01/2023 19:00,13,8,5,12,3,9,14,4,10,0,0,0,3,3,0,12,12,0,0,0,0,125,70,55,0,,90,0,90,74,2,72
13/01/2023 20:00,11,4,7,6,1,5,13,5,8,0,0,0,4,4,0,8,8,0,1,1,0,126,76,50,0,,73,2,71,62,1,61
13/01/2023 21:00,9,4,5,7,2,5,13,5,8,0,0,0,5,5,0,3,3,0,0,0,0,65,44,21,0,,54,0,54,49,1,48
13/01/2023 22:00,4,4,0,2,1,1,4,1,3,0,0,0,5,4,1,5,5,0,0,0,0,41,25,16,0,,40,0,40,45,0,45
13/01/2023 23:00,3,3,0,1,0,1,3,0,3,0,0,0,0,0,0,5,5,0,0,0,0,32,25,7,0,,35,0,35,25,0,25
14/01/2023 00:00,4,1,3,3,1,2,2,1,1,0,0,0,0,0,0,3,3,0,0,0,0,21,13,8,0,,16,0,16,9,0,9
14/01/2023 01:00,0,0,0,2,1,1,2,1,1,0,0,0,0,0,0,0,0,0,0,0,0,8,5,3,0,,5,0,5,0,0,0
14/01/2023 02:00,0,0,0,0,0,0,0,0,0,0,0,0,0,0,0,0,0,0,0,0,0,7,5,2,0,,15,0,15,7,0,7
14/01/2023 03:00,0,0,0,0,0,0,1,0,1,0,0,0,0,0,0,0,0,0,0,0,0,12,10,2,0,,9,0,9,3,0,3
14/01/2023 04:00,1,1,0,0,0,0,0,0,0,0,0,0,0,0,0,0,0,0,0,0,0,7,4,3,0,,3,0,3,0,0,0
14/01/2023 05:00,2,0,2,1,1,0,1,1,0,0,0,0,2,2,0,1,1,0,0,0,0,6,3,3,0,,1,0,1,4,0,4
14/01/2023 06:00,0,0,0,4,2,2,4,3,1,0,0,0,2,2,0,1,1,0,0,0,0,23,3,20,0,,4,0,4,5,0,5
14/01/2023 07:00,6,6,0,10,2,8,10,1,9,0,0,0,4,4,0,1,1,0,0,0,0,30,9,21,0,,11,0,11,10,0,10
14/01/2023 08:00,3,1,2,35,15,20,34,12,22,0,0,0,12,12,0,3,3,0,5,5,0,50,20,30,0,,9,0,9,19,0,19
14/01/2023 09:00,8,6,2,66,29,37,50,20,30,0,0,0,10,10,0,11,11,0,13,13,0,64,15,49,0,,12,0,12,54,0,54
14/01/2023 10:00,5,4,1,63,28,35,63,23,40,0,0,0,3,3,0,15,15,0,10,10,0,82,26,56,0,,34,0,34,62,1,61
14/01/2023 11:00,9,4,5,83,36,47,109,43,66,0,0,0,2,2,0,9,9,0,11,11,0,95,35,60,0,,48,0,48,49,0,49
14/01/2023 12:00,13,8,5,57,26,31,70,29,41,0,0,0,2,2,0,16,16,0,8,8,0,111,40,71,0,,51,0,51,68,0,68
14/01/2023 13:00,8,4,4,43,18,25,62,25,37,0,0,0,1,1,0,8,8,0,6,6,0,98,45,53,0,,63,0,63,67,0,67
14/01/2023 14:00,8,5,3,37,18,19,48,22,26,0,0,0,1,1,0,11,11,0,6,6,0,99,40,59,0,,73,2,71,64,0,64
14/01/2023 15:00,10,5,5,37,12,25,50,24,26,0,0,0,1,1,0,5,5,0,10,10,0,92,38,54,0,,62,0,62,47,0,47
14/01/2023 16:00,13,5,8,24,14,10,29,19,10,0,0,0,5,5,0,10,10,0,10,10,0,82,40,42,0,,61,0,61,53,0,53
14/01/2023 17:00,5,5,0,14,7,7,22,11,11,0,0,0,3,3,0,6,6,0,4,4,0,116,45,71,0,,67,0,67,66,1,65
14/01/2023 18:00,9,6,3,5,2,3,10,7,3,0,0,0,1,1,0,9,9,0,1,1,0,94,42,52,0,,81,0,81,57,0,57
14/01/2023 19:00,7,1,6,7,3,4,12,5,7,0,0,0,1,1,0,9,9,0,2,2,0,73,32,41,0,,67,0,67,71,0,71
14/01/2023 20:00,4,2,2,3,2,1,8,4,4,0,0,0,4,4,0,4,4,0,2,2,0,84,41,43,0,,45,0,45,40,1,39
14/01/2023 21:00,2,1,1,6,4,2,6,3,3,0,0,0,1,1,0,6,6,0,1,1,0,45,21,24,0,,32,0,32,35,0,35
14/01/2023 22:00,5,4,1,2,2,0,2,0,2,0,0,0,1,1,0,3,3,0,4,4,0,35,22,13,0,,27,2,25,16,0,16
14/01/2023 23:00,6,2,4,0,0,0,3,1,2,0,0,0,0,0,0,0,0,0,1,1,0,37,24,13,0,,23,1,22,11,0,11
15/01/2023 00:00,3,3,0,0,0,0,2,1,1,0,0,0,0,0,0,2,2,0,0,0,0,29,21,8,0,,27,0,27,11,0,11
15/01/2023 01:00,1,0,1,3,2,1,3,2,1,0,0,0,1,1,0,1,1,0,0,0,0,10,7,3,0,,5,0,5,1,0,1
15/01/2023 02:00,1,0,1,0,0,0,0,0,0,0,0,0,0,0,0,1,1,0,0,0,0,14,10,4,0,,8,0,8,2,0,2
15/01/2023 03:00,2,0,2,2,0,2,2,0,2,0,0,0,0,0,0,0,0,0,0,0,0,11,8,3,0,,2,0,2,1,0,1
15/01/2023 04:00,1,0,1,0,0,0,1,0,1,0,0,0,0,0,0,1,1,0,0,0,0,2,2,0,0,,3,0,3,0,0,0
15/01/2023 05:00,0,0,0,3,1,2,2,1,1,0,0,0,1,1,0,1,1,0,0,0,0,6,3,3,0,,3,0,3,2,0,2
15/01/2023 06:00,1,1,0,2,1,1,3,0,3,0,0,0,1,1,0,0,0,0,0,0,0,21,2,19,0,,3,0,3,3,0,3
15/01/2023 07:00,2,0,2,9,3,6,9,3,6,0,0,0,2,2,0,1,1,0,1,1,0,9,3,6,0,,3,0,3,2,0,2
15/01/2023 08:00,1,1,0,42,19,23,39,19,20,0,0,0,2,2,0,2,2,0,4,4,0,26,10,16,0,,3,0,3,10,0,10
15/01/2023 09:00,8,7,1,75,28,47,81,34,47,0,0,0,2,2,0,9,9,0,2,2,0,44,9,35,0,,6,0,6,31,0,31
15/01/2023 10:00,4,3,1,103,39,64,114,41,73,0,0,0,4,4,0,12,12,0,0,0,0,69,25,44,0,,24,0,24,38,0,38
15/01/2023 11:00,6,4,2,107,51,56,105,49,56,0,0,0,3,3,0,10,10,0,1,1,0,71,20,51,0,,24,0,24,44,0,44
15/01/2023 12:00,10,5,5,109,59,50,140,70,70,0,0,0,0,0,0,9,9,0,0,0,0,89,26,63,0,,51,0,51,63,0,63
15/01/2023 13:00,5,3,2,71,41,30,90,47,43,0,0,0,2,2,0,10,10,0,9,9,0,85,30,55,0,,36,0,36,50,0,50
15/01/2023 14:00,5,3,2,77,42,35,72,39,33,0,0,0,4,4,0,12,12,0,8,8,0,85,31,54,0,,45,0,45,68,1,67
15/01/2023 15:00,12,6,6,55,32,23,70,37,33,0,0,0,0,0,0,5,5,0,0,0,0,74,36,38,0,,56,0,56,57,0,57
15/01/2023 16:00,11,5,6,25,18,7,43,25,18,0,0,0,0,0,0,3,3,0,0,0,0,67,24,43,0,,61,0,61,46,0,46
15/01/2023 17:00,8,5,3,24,10,14,25,12,13,0,0,0,1,1,0,4,4,0,0,0,0,84,42,42,0,,50,0,50,37,0,37
15/01/2023 18:00,5,2,3,14,6,8,20,10,10,0,0,0,2,2,0,4,4,0,1,1,0,116,55,61,0,,56,0,56,51,0,51
15/01/2023 19:00,5,2,3,4,2,2,9,4,5,0,0,0,1,1,0,3,3,0,0,0,0,75,35,40,0,,70,0,70,77,0,77
15/01/2023 20:00,2,0,2,14,6,8,12,5,7,0,0,0,2,2,0,8,8,0,0,0,0,63,29,34,0,,41,1,40,42,0,42
15/01/2023 21:00,4,2,2,6,5,1,11,7,4,0,0,0,1,1,0,4,4,0,0,0,0,38,19,19,0,,34,0,34,40,0,40
15/01/2023 22:00,1,1,0,4,2,2,1,1,0,0,0,0,1,1,0,3,3,0,2,2,0,25,14,11,0,,23,2,21,25,0,25
15/01/2023 23:00,2,0,2,2,0,2,2,0,2,0,0,0,0,0,0,1,1,0,1,1,0,12,7,5,0,,19,0,19,18,0,18
16/01/2023 00:00,2,0,2,2,2,0,2,1,1,0,0,0,0,0,0,1,1,0,0,0,0,11,8,3,0,,8,0,8,3,0,3
16/01/2023 01:00,2,0,2,3,1,2,1,0,1,0,0,0,1,1,0,1,1,0,0,0,0,4,3,1,0,,0,0,0,0,0,0
16/01/2023 02:00,0,0,0,0,0,0,1,0,1,0,0,0,0,0,0,0,0,0,0,0,0,4,3,1,0,,4,0,4,0,0,0
16/01/2023 03:00,0,0,0,1,1,0,1,0,1,0,0,0,0,0,0,0,0,0,0,0,0,1,0,1,0,,3,0,3,1,0,1
16/01/2023 04:00,0,0,0,0,0,0,1,0,1,0,0,0,1,1,0,1,1,0,0,0,0,3,1,2,0,,0,0,0,0,0,0
16/01/2023 05:00,1,1,0,5,3,2,7,5,2,0,0,0,0,0,0,1,1,0,0,0,0,30,3,27,0,,3,0,3,3,0,3
16/01/2023 06:00,11,11,0,16,12,4,20,18,2,0,0,0,5,5,0,3,3,0,0,0,0,108,26,82,0,,5,0,5,15,0,15
16/01/2023 07:00,25,20,5,40,34,6,56,46,10,0,0,0,13,13,0,13,13,0,4,4,0,232,58,174,0,,28,0,28,55,0,55
16/01/2023 08:00,77,66,11,51,44,7,69,55,14,0,0,0,47,47,0,35,35,0,52,52,0,460,79,381,0,,50,1,49,127,0,127
16/01/2023 09:00,38,33,5,38,27,11,41,28,13,0,0,0,13,13,0,7,7,0,7,7,0,182,31,151,0,,26,0,26,105,0,105
16/01/2023 10:00,9,8,1,28,13,15,35,18,17,0,0,0,5,5,0,7,7,0,6,6,0,84,25,59,0,,26,0,26,46,0,46
16/01/2023 11:00,9,6,3,31,17,14,42,18,24,0,0,0,7,7,0,5,5,0,9,9,0,53,14,39,0,,27,0,27,31,0,31
16/01/2023 12:00,10,4,6,41,21,20,42,19,23,0,0,0,5,5,0,7,7,0,8,8,0,93,24,69,0,,48,1,47,57,0,57
16/01/2023 13:00,8,5,3,43,18,25,55,25,30,0,0,0,0,0,0,10,10,0,14,14,0,85,32,53,0,,73,0,73,63,0,63
16/01/2023 14:00,14,6,8,42,19,23,48,18,30,0,0,0,5,5,0,21,21,0,9,9,0,81,42,39,0,,53,0,53,42,1,41
16/01/2023 15:00,18,8,10,44,13,31,55,21,34,0,0,0,3,3,0,55,55,0,15,15,0,134,76,58,0,,52,0,52,54,0,54
16/01/2023 16:00,29,10,19,49,19,30,60,21,39,0,0,0,0,0,0,39,39,0,7,7,0,203,121,82,0,,105,0,105,58,0,58
16/01/2023 17:00,38,12,26,67,11,56,99,24,75,0,0,0,0,0,0,38,38,0,8,8,0,347,239,108,0,,222,1,221,75,1,74
16/01/2023 18:00,26,5,21,63,14,49,79,19,60,0,0,0,2,2,0,19,19,0,0,0,0,265,160,105,0,,148,2,146,80,0,80
16/01/2023 19:00,16,6,10,23,9,14,27,9,18,0,0,0,0,0,0,13,13,0,2,2,0,148,95,53,0,,95,0,95,54,0,54
16/01/2023 20:00,6,2,4,10,2,8,17,4,13,0,0,0,1,1,0,4,4,0,4,4,0,89,59,30,0,,81,0,81,55,0,55
16/01/2023 21:00,4,1,3,9,4,5,9,5,4,0,0,0,0,0,0,9,9,0,2,2,0,54,32,22,0,,51,0,51,34,0,34
16/01/2023 22:00,12,5,7,5,1,4,9,3,6,0,0,0,2,2,0,4,4,0,2,2,0,43,26,17,0,,36,1,35,13,0,13
16/01/2023 23:00,3,0,3,1,0,1,1,0,1,0,0,0,0,0,0,1,1,0,1,1,0,16,12,4,0,,7,0,7,2,0,2
17/01/2023 00:00,1,0,1,1,0,1,1,0,1,0,0,0,1,1,0,0,0,0,0,0,0,8,6,2,0,,12,0,12,6,0,6
17/01/2023 01:00,1,0,1,2,2,0,0,0,0,0,0,0,0,0,0,0,0,0,0,0,0,2,1,1,0,,0,0,0,1,0,1
17/01/2023 02:00,0,0,0,0,0,0,0,0,0,0,0,0,0,0,0,0,0,0,0,0,0,1,0,1,0,,2,0,2,0,0,0
17/01/2023 03:00,0,0,0,1,1,0,1,0,1,0,0,0,0,0,0,0,0,0,0,0,0,2,1,1,0,,2,0,2,0,0,0
17/01/2023 04:00,1,1,0,1,1,0,1,1,0,0,0,0,2,2,0,0,0,0,0,0,0,3,1,2,0,,1,0,1,0,0,0
17/01/2023 05:00,1,1,0,3,3,0,3,2,1,0,0,0,1,1,0,1,1,0,0,0,0,27,3,24,0,,2,0,2,6,0,6
17/01/2023 06:00,14,11,3,14,12,2,17,15,2,0,0,0,5,5,0,7,7,0,0,0,0,101,27,74,0,,8,0,8,18,0,18
17/01/2023 07:00,36,34,2,40,33,7,52,46,6,0,0,0,7,7,0,14,14,0,1,1,0,282,64,218,0,,36,0,36,58,0,58
17/01/2023 08:00,88,77,11,49,45,4,80,70,10,0,0,0,47,47,0,50,50,0,12,12,0,524,75,449,0,,52,1,51,125,1,124
17/01/2023 09:00,38,31,7,18,12,6,37,30,7,0,0,0,24,24,0,16,16,0,2,2,0,217,29,188,0,,28,1,27,89,0,89
17/01/2023 10:00,10,8,2,14,8,6,21,11,10,0,0,0,9,9,0,7,7,0,1,1,0,74,19,55,0,,18,0,18,28,0,28
17/01/2023 11:00,5,4,1,17,6,11,16,7,9,0,0,0,8,8,0,4,4,0,1,1,0,63,20,43,0,,30,0,30,55,1,54
17/01/2023 12:00,13,11,2,26,13,13,29,12,17,0,0,0,1,1,0,11,11,0,0,0,0,86,22,64,0,,40,0,40,71,1,70
17/01/2023 13:00,15,8,7,22,8,14,42,16,26,0,0,0,3,3,0,5,5,0,0,0,0,91,37,54,0,,49,2,47,65,0,65
17/01/2023 14:00,11,7,4,21,9,12,34,12,22,0,0,0,0,0,0,14,14,0,0,0,0,112,52,60,0,,35,0,35,33,0,33
17/01/2023 15:00,10,3,7,27,12,15,33,11,22,0,0,0,0,0,0,33,33,0,1,1,0,123,67,56,0,,61,0,61,50,0,50
17/01/2023 16:00,19,8,11,52,18,34,60,17,43,0,0,0,0,0,0,38,38,0,0,0,0,210,118,92,0,,104,0,104,66,0,66
17/01/2023 17:00,49,12,37,50,11,39,75,14,61,0,0,0,1,1,0,36,36,0,2,2,0,385,272,113,0,,202,1,201,98,2,96
17/01/2023 18:00,27,7,20,48,5,43,69,9,60,0,0,0,2,2,0,31,31,0,0,0,0,303,220,83,0,,196,0,196,76,0,76
17/01/2023 19:00,12,4,8,21,7,14,29,4,25,0,0,0,1,1,0,15,15,0,0,0,0,160,107,53,0,,110,0,110,47,0,47
17/01/2023 20:00,12,3,9,9,4,5,11,5,6,0,0,0,0,0,0,6,6,0,0,0,0,126,90,36,0,,81,0,81,67,1,66
17/01/2023 21:00,3,2,1,9,3,6,15,5,10,0,0,0,0,0,0,11,11,0,0,0,0,72,48,24,0,,52,0,52,32,0,32
17/01/2023 22:00,12,4,8,2,1,1,6,1,5,0,0,0,1,1,0,3,3,0,0,0,0,37,22,15,0,,25,0,25,18,1,17
17/01/2023 23:00,5,0,5,1,0,1,2,0,2,0,0,0,1,1,0,3,3,0,0,0,0,23,15,8,0,,14,0,14,12,0,12
18/01/2023 00:00,3,3,0,2,2,0,2,2,0,0,0,0,0,0,0,0,0,0,0,0,0,16,10,6,0,,9,0,9,2,0,2
18/01/2023 01:00,0,0,0,0,0,0,0,0,0,0,0,0,0,0,0,0,0,0,0,0,0,3,1,2,0,,1,0,1,0,0,0
18/01/2023 02:00,1,0,1,0,0,0,1,1,0,0,0,0,0,0,0,0,0,0,0,0,0,3,2,1,0,,6,0,6,2,0,2
18/01/2023 03:00,0,0,0,0,0,0,0,0,0,0,0,0,0,0,0,0,0,0,0,0,0,1,1,0,0,,2,0,2,1,0,1
18/01/2023 04:00,1,1,0,0,0,0,1,0,1,0,0,0,0,0,0,0,0,0,0,0,0,5,1,4,0,,1,0,1,1,0,1
18/01/2023 05:00,1,1,0,6,4,2,5,3,2,0,0,0,1,1,0,1,1,0,0,0,0,22,1,21,0,,3,0,3,7,0,7
18/01/2023 06:00,9,8,1,11,10,1,13,11,2,0,0,0,7,7,0,4,4,0,0,0,0,107,26,81,0,,6,0,6,12,0,12
18/01/2023 07:00,30,26,4,25,20,5,46,40,6,0,0,0,8,8,0,11,11,0,0,0,0,269,64,205,0,,34,0,34,68,0,68
18/01/2023 08:00,81,68,13,54,47,7,77,66,11,0,0,0,46,46,0,36,36,0,0,0,0,562,84,478,0,,50,1,49,162,0,162
18/01/2023 09:00,39,33,6,26,21,5,43,34,9,0,0,0,7,7,0,11,11,0,0,0,0,197,28,169,0,,32,0,32,95,0,95
18/01/2023 10:00,16,14,2,19,9,10,21,7,14,0,0,0,3,3,0,5,5,0,0,0,0,70,18,52,0,,23,1,22,32,0,32
18/01/2023 11:00,7,5,2,26,16,10,28,16,12,0,0,0,2,2,0,6,6,0,1,1,0,67,23,44,0,,26,0,26,55,0,55
18/01/2023 12:00,9,6,3,30,8,22,25,9,16,0,0,0,0,0,0,11,11,0,0,0,0,79,32,47,0,,46,0,46,69,0,69
18/01/2023 13:00,13,4,9,30,16,14,32,12,20,0,0,0,4,4,0,23,23,0,0,0,0,99,46,53,0,,67,2,65,57,0,57
18/01/2023 14:00,13,9,4,32,15,17,27,12,15,0,0,0,0,0,0,13,13,0,0,0,0,87,41,46,0,,59,0,59,41,0,41
18/01/2023 15:00,17,8,9,17,5,12,22,5,17,0,0,0,2,2,0,41,41,0,1,1,0,114,60,54,0,,60,1,59,48,1,47
18/01/2023 16:00,28,6,22,34,11,23,46,10,36,0,0,0,0,0,0,23,23,0,0,0,0,211,135,76,0,,98,0,98,63,0,63
18/01/2023 17:00,34,14,20,46,7,39,81,17,64,0,0,0,0,0,0,29,29,0,1,1,0,374,240,134,0,,205,0,205,62,0,62
18/01/2023 18:00,27,9,18,57,9,48,78,11,67,0,0,0,0,0,0,24,24,0,0,0,0,308,209,99,0,,177,1,176,37,1,36
18/01/2023 19:00,14,3,11,34,11,23,30,7,23,0,0,0,2,2,0,11,11,0,0,0,0,146,94,52,0,,129,0,129,67,0,67
18/01/2023 20:00,15,6,9,11,5,6,20,7,13,0,0,0,0,0,0,12,12,0,3,3,0,91,60,31,0,,93,0,93,54,0,54
18/01/2023 21:00,2,0,2,15,5,10,13,6,7,0,0,0,0,0,0,3,3,0,1,1,0,62,42,20,0,,55,0,55,32,0,32
18/01/2023 22:00,6,3,3,4,1,3,7,1,6,0,0,0,1,1,0,2,2,0,2,2,0,53,40,13,0,,43,1,42,14,0,14
18/01/2023 23:00,2,2,0,0,0,0,3,0,3,0,0,0,0,0,0,3,3,0,0,0,0,22,14,8,0,,26,0,26,16,0,16
19/01/2023 00:00,0,0,0,2,1,1,1,1,0,0,0,0,2,2,0,1,1,0,0,0,0,12,10,2,0,,9,0,9,5,0,5
19/01/2023 01:00,1,1,0,2,2,0,3,2,1,0,0,0,0,0,0,0,0,0,0,0,0,0,0,0,0,,0,0,0,1,0,1
19/01/2023 02:00,0,0,0,0,0,0,2,2,0,0,0,0,0,0,0,0,0,0,0,0,0,2,2,0,0,,3,0,3,1,0,1
19/01/2023 03:00,0,0,0,1,0,1,1,0,1,0,0,0,0,0,0,0,0,0,1,1,0,3,1,2,0,,1,0,1,2,0,2
19/01/2023 04:00,2,2,0,0,0,0,1,0,1,0,0,0,1,1,0,1,1,0,1,1,0,3,1,2,0,,2,0,2,0,0,0
19/01/2023 05:00,0,0,0,4,3,1,3,2,1,0,0,0,1,1,0,1,1,0,0,0,0,22,4,18,0,,2,0,2,5,0,5
19/01/2023 06:00,13,12,1,12,8,4,17,12,5,0,0,0,3,3,0,5,5,0,0,0,0,101,22,79,0,,7,0,7,17,0,17
19/01/2023 07:00,31,26,5,28,23,5,39,34,5,0,0,0,9,9,0,12,12,0,1,1,0,261,50,211,0,,25,0,25,61,0,61
19/01/2023 08:00,87,72,15,56,49,7,78,63,15,0,0,0,40,40,0,42,42,0,32,32,0,555,85,470,0,,45,0,45,155,3,152
19/01/2023 09:00,46,40,6,33,23,10,58,42,16,0,0,0,21,21,0,13,13,0,6,6,0,221,29,192,0,,35,0,35,93,0,93
19/01/2023 10:00,4,3,1,23,17,6,23,12,11,0,0,0,4,4,0,5,5,0,2,2,0,66,12,54,0,,29,1,28,19,0,19
19/01/2023 11:00,9,7,2,44,17,27,43,19,24,0,0,0,5,5,0,3,3,0,2,2,0,76,21,55,0,,27,0,27,53,0,53
19/01/2023 12:00,16,8,8,53,23,30,54,28,26,0,0,0,5,5,0,10,10,0,2,2,0,94,39,55,0,,42,0,42,62,0,62
19/01/2023 13:00,12,6,6,51,24,27,59,30,29,0,0,0,4,4,0,8,8,0,3,3,0,110,53,57,0,,78,0,78,79,0,79
19/01/2023 14:00,14,7,7,34,18,16,54,30,24,0,0,0,0,0,0,14,14,0,0,0,0,98,52,46,0,,57,2,55,60,1,59
19/01/2023 15:00,20,10,10,40,13,27,39,15,24,0,0,0,0,0,0,27,27,0,1,1,0,117,59,58,0,,64,0,64,59,0,59
19/01/2023 16:00,29,7,22,41,21,20,37,15,22,0,0,0,0,0,0,38,38,0,2,2,0,216,137,79,0,,114,1,113,66,0,66
19/01/2023 17:00,41,11,30,60,12,48,93,23,70,0,0,0,1,1,0,35,35,0,5,5,0,373,241,132,0,,197,0,197,110,0,110
19/01/2023 18:00,27,11,16,70,18,52,93,20,73,0,0,0,1,1,0,38,38,0,1,1,0,315,218,97,0,,180,0,180,90,1,89
19/01/2023 19:00,14,6,8,27,8,19,39,13,26,0,0,0,1,1,0,24,24,0,3,3,0,177,108,69,0,,134,0,134,96,0,96
19/01/2023 20:00,12,7,5,19,11,8,27,14,13,0,0,0,1,1,0,13,13,0,3,3,0,118,84,34,0,,84,1,83,40,0,40
19/01/2023 21:00,4,3,1,9,0,9,19,3,16,0,0,0,1,1,0,11,11,0,4,4,0,76,48,28,0,,76,0,76,46,1,45
19/01/2023 22:00,5,2,3,6,2,4,14,4,10,0,0,0,2,2,0,2,2,0,1,1,0,52,32,20,0,,51,0,51,33,0,33
19/01/2023 23:00,0,0,0,1,0,1,2,0,2,0,0,0,1,1,0,2,2,0,1,1,0,39,29,10,0,,31,0,31,12,0,12
20/01/2023 00:00,0,0,0,3,2,1,2,2,0,0,0,0,0,0,0,1,1,0,1,1,0,17,14,3,0,,20,0,20,6,0,6
20/01/2023 01:00,0,0,0,0,0,0,0,0,0,0,0,0,0,0,0,1,1,0,0,0,0,6,4,2,0,,0,0,0,1,0,1
20/01/2023 02:00,0,0,0,1,0,1,1,0,1,0,0,0,0,0,0,0,0,0,0,0,0,3,2,1,0,,5,0,5,1,0,1
20/01/2023 03:00,0,0,0,0,0,0,0,0,0,0,0,0,0,0,0,0,0,0,0,0,0,6,4,2,0,,7,0,7,2,0,2
20/01/2023 04:00,1,0,1,1,1,0,2,1,1,0,0,0,0,0,0,1,1,0,0,0,0,3,1,2,0,,1,0,1,0,0,0
20/01/2023 05:00,4,2,2,2,1,1,2,1,1,0,0,0,1,1,0,0,0,0,0,0,0,19,3,16,0,,2,0,2,8,0,8
20/01/2023 06:00,10,10,0,5,5,0,9,9,0,0,0,0,6,6,0,6,6,0,1,1,0,90,20,70,0,,4,0,4,12,0,12
20/01/2023 07:00,16,13,3,18,14,4,28,23,5,0,0,0,1,1,0,6,6,0,0,0,0,191,54,137,0,,24,0,24,43,0,43
20/01/2023 08:00,43,36,7,38,26,12,37,30,7,0,0,0,22,22,0,25,25,0,3,3,0,337,71,266,0,,37,1,36,73,0,73
20/01/2023 09:00,29,22,7,28,16,12,39,27,12,0,0,0,8,8,0,7,7,0,0,0,0,149,20,129,0,,33,2,31,47,0,47
20/01/2023 10:00,8,6,2,20,10,10,28,17,11,0,0,0,3,3,0,3,3,0,0,0,0,34,11,23,0,,23,0,23,22,0,22
20/01/2023 11:00,11,9,2,23,12,11,23,8,15,0,0,0,1,1,0,5,5,0,0,0,0,22,22,0,0,,30,1,29,26,1,25
20/01/2023 12:00,18,10,8,45,17,28,54,24,30,0,0,0,2,2,0,12,12,0,0,0,0,96,40,56,0,,60,0,60,59,0,59
20/01/2023 13:00,20,11,9,39,19,20,49,24,25,0,0,0,3,2,1,42,42,0,1,1,0,112,49,63,0,,72,0,72,72,0,72
20/01/2023 14:00,14,8,6,40,13,27,39,8,31,0,0,0,3,3,0,16,16,0,0,0,0,116,63,53,0,,74,0,74,65,0,65
20/01/2023 15:00,17,8,9,41,17,24,52,23,29,0,0,0,3,3,0,25,25,0,2,2,0,153,77,76,0,,72,0,72,49,1,48
20/01/2023 16:00,27,11,16,44,23,21,67,25,42,0,0,0,3,3,0,27,27,0,0,0,0,196,103,93,0,,109,1,108,63,0,63
20/01/2023 17:00,34,10,24,50,19,31,82,29,53,0,0,0,4,4,0,26,26,0,0,0,0,272,163,109,0,,164,0,164,97,0,97
20/01/2023 18:00,17,10,7,43,13,30,48,13,35,0,0,0,5,5,0,13,13,0,2,2,0,208,110,98,0,,138,1,137,89,0,89
20/01/2023 19:00,7,3,4,11,4,7,20,6,14,0,0,0,2,2,0,19,19,0,2,2,0,159,85,74,0,,121,0,121,78,2,76
20/01/2023 20:00,7,3,4,7,4,3,16,5,11,0,0,0,1,1,0,3,3,0,0,0,0,98,55,43,0,,75,2,73,58,0,58
20/01/2023 21:00,7,4,3,3,0,3,4,0,4,0,0,0,2,2,0,4,4,0,0,0,0,78,39,39,0,,68,0,68,68,0,68
20/01/2023 22:00,7,3,4,2,1,1,7,2,5,0,0,0,3,3,0,3,3,0,1,1,0,65,47,18,0,,40,0,40,36,1,35
20/01/2023 23:00,5,3,2,1,0,1,2,0,2,0,0,0,0,0,0,1,1,0,0,0,0,30,25,5,0,,32,0,32,14,0,14
21/01/2023 00:00,0,0,0,0,0,0,2,1,1,0,0,0,0,0,0,3,3,0,0,0,0,30,18,12,0,,27,0,27,7,0,7
21/01/2023 01:00,2,0,2,0,0,0,0,0,0,0,0,0,0,0,0,1,1,0,0,0,0,12,5,7,0,,4,0,4,2,0,2
21/01/2023 02:00,0,0,0,0,0,0,0,0,0,0,0,0,1,1,0,1,1,0,0,0,0,7,3,4,0,,11,0,11,8,0,8
21/01/2023 03:00,1,0,1,1,1,0,1,0,1,0,0,0,0,0,0,0,0,0,1,1,0,11,6,5,0,,10,0,10,2,0,2
21/01/2023 04:00,0,0,0,0,0,0,1,0,1,0,0,0,0,0,0,0,0,0,0,0,0,8,5,3,0,,4,0,4,2,0,2
21/01/2023 05:00,0,0,0,0,0,0,1,0,1,0,0,0,0,0,0,1,1,0,0,0,0,8,4,4,0,,2,0,2,2,0,2
21/01/2023 06:00,0,0,0,5,2,3,5,1,4,0,0,0,2,2,0,1,1,0,0,0,0,22,7,15,0,,3,0,3,9,0,9
21/01/2023 07:00,8,3,5,7,3,4,14,5,9,0,0,0,4,4,0,1,1,0,0,0,0,44,11,33,0,,12,0,12,7,0,7
21/01/2023 08:00,6,3,3,33,14,19,30,9,21,0,0,0,1,1,0,6,6,0,0,0,0,56,14,42,0,,13,0,13,32,0,32
21/01/2023 09:00,6,4,2,85,35,50,100,38,62,0,0,0,8,8,0,13,13,0,0,0,0,73,22,51,0,,16,0,16,47,0,47
21/01/2023 10:00,11,6,5,92,42,50,118,42,76,0,0,0,7,7,0,13,13,0,1,1,0,78,25,53,0,,29,0,29,56,0,56
21/01/2023 11:00,17,9,8,106,55,51,122,58,64,0,0,0,3,3,0,21,21,0,1,1,0,113,50,63,0,,34,0,34,47,0,47
21/01/2023 12:00,13,8,5,77,40,37,117,58,59,0,0,0,5,5,0,21,21,0,3,3,0,122,39,83,0,,50,0,50,67,1,66
21/01/2023 13:00,9,6,3,63,39,24,81,49,32,0,0,0,3,3,0,10,10,0,3,3,0,127,42,85,0,,79,1,78,75,0,75
21/01/2023 14:00,10,6,4,43,26,17,64,35,29,0,0,0,4,4,0,10,10,0,1,1,0,124,55,69,0,,66,1,65,89,0,89
21/01/2023 15:00,9,5,4,34,18,16,47,24,23,0,0,0,2,2,0,7,7,0,0,0,0,98,36,62,0,,77,1,76,58,0,58
21/01/2023 16:00,4,1,3,23,16,7,24,13,11,0,0,0,4,4,0,4,4,0,0,0,0,87,33,54,0,,82,2,80,74,0,74
21/01/2023 17:00,5,3,2,20,9,11,33,14,19,0,0,0,4,4,0,7,7,0,0,0,0,128,54,74,0,,84,1,83,58,1,57
21/01/2023 18:00,5,3,2,11,3,8,19,6,13,0,0,0,4,4,0,13,13,0,0,0,0,144,64,80,0,,99,1,98,62,1,61
21/01/2023 19:00,4,1,3,4,3,1,7,2,5,0,0,0,3,3,0,5,5,0,0,0,0,92,39,53,0,,75,0,75,66,1,65
21/01/2023 20:00,8,4,4,6,2,4,5,3,2,0,0,0,6,6,0,4,4,0,0,0,0,71,33,38,0,,80,0,80,57,1,56
21/01/2023 21:00,4,3,1,2,0,2,5,3,2,0,0,0,6,6,0,1,1,0,0,0,0,43,26,17,0,,52,1,51,43,0,43
21/01/2023 22:00,6,5,1,1,0,1,3,1,2,0,0,0,1,1,0,1,1,0,0,0,0,36,21,15,0,,46,0,46,26,0,26
21/01/2023 23:00,4,4,0,0,0,0,3,0,3,0,0,0,2,2,0,1,1,0,0,0,0,42,26,16,0,,29,0,29,24,0,24
22/01/2023 00:00,2,2,0,3,2,1,6,2,4,0,0,0,1,1,0,0,0,0,0,0,0,30,20,10,0,,35,0,35,11,0,11
22/01/2023 01:00,0,0,0,1,1,0,1,1,0,0,0,0,1,1,0,0,0,0,0,0,0,14,12,2,0,,4,0,4,1,0,1
22/01/2023 02:00,0,0,0,0,0,0,1,0,1,0,0,0,1,1,0,1,1,0,0,0,0,10,5,5,0,,16,0,16,8,0,8
22/01/2023 03:00,0,0,0,0,0,0,1,0,1,0,0,0,1,1,0,0,0,0,0,0,0,14,9,5,0,,11,0,11,5,0,5
22/01/2023 04:00,1,0,1,0,0,0,0,0,0,0,0,0,0,0,0,0,0,0,0,0,0,8,7,1,0,,4,0,4,3,0,3
22/01/2023 05:00,2,1,1,0,0,0,1,0,1,0,0,0,0,0,0,0,0,0,1,1,0,4,4,0,0,,2,0,2,4,0,4
22/01/2023 06:00,1,0,1,5,2,3,4,3,1,0,0,0,1,1,0,0,0,0,0,0,0,20,6,14,0,,2,0,2,7,0,7
22/01/2023 07:00,1,1,0,10,5,5,12,1,11,0,0,0,3,3,0,2,2,0,0,0,0,25,9,16,0,,9,0,9,3,0,3
22/01/2023 08:00,0,0,0,40,19,21,35,19,16,0,0,0,4,4,0,2,2,0,1,1,0,33,14,19,0,,11,0,11,13,0,13
22/01/2023 09:00,6,6,0,54,23,31,64,26,38,0,0,0,3,3,0,6,6,0,3,3,0,51,14,37,0,,14,0,14,20,0,20
22/01/2023 10:00,5,4,1,85,34,51,125,45,80,0,0,0,8,8,0,9,9,0,6,6,0,61,22,39,0,,15,0,15,32,0,32
22/01/2023 11:00,8,3,5,98,48,50,113,51,62,0,0,0,6,6,0,15,15,0,2,2,0,72,35,37,0,,35,0,35,43,2,41
22/01/2023 12:00,10,6,4,146,71,75,184,89,95,0,0,0,3,3,0,7,7,0,0,0,0,84,42,42,0,,38,0,38,65,0,65
22/01/2023 13:00,11,8,3,97,59,38,114,64,50,0,0,0,0,0,0,12,12,0,1,1,0,97,25,72,0,,39,0,39,84,0,84
22/01/2023 14:00,13,10,3,73,38,35,104,54,50,0,0,0,1,1,0,15,15,0,0,0,0,82,35,47,0,,66,0,66,71,1,70
22/01/2023 15:00,7,2,5,51,33,18,61,32,29,0,0,0,2,2,0,5,5,0,0,0,0,88,25,63,0,,40,0,40,54,1,53
22/01/2023 16:00,13,7,6,30,18,12,53,33,20,0,0,0,5,4,1,10,10,0,0,0,0,102,41,61,0,,58,1,57,56,1,55
22/01/2023 17:00,9,7,2,13,6,7,32,20,12,0,0,0,1,1,0,5,5,0,0,0,0,87,42,45,0,,68,0,68,67,0,67
22/01/2023 18:00,13,11,2,15,8,7,21,11,10,0,0,0,7,7,0,9,9,0,1,1,0,91,33,58,0,,89,1,88,81,1,80
22/01/2023 19:00,13,6,7,7,3,4,20,7,13,0,0,0,1,1,0,12,12,0,0,0,0,84,35,49,0,,62,0,62,83,0,83
22/01/2023 20:00,4,2,2,4,2,2,13,5,8,0,0,0,0,0,0,1,1,0,0,0,0,61,32,29,0,,58,0,58,57,1,56
22/01/2023 21:00,5,3,2,6,3,3,10,3,7,0,0,0,2,2,0,2,2,0,0,0,0,51,29,22,0,,45,0,45,40,0,40
22/01/2023 22:00,7,6,1,4,3,1,9,5,4,0,0,0,1,1,0,2,2,0,1,1,0,30,17,13,0,,23,0,23,27,0,27
22/01/2023 23:00,3,2,1,0,0,0,2,0,2,0,0,0,1,1,0,0,0,0,0,0,0,21,18,3,0,,19,0,19,9,0,9
23/01/2023 00:00,0,0,0,1,0,1,3,0,3,0,0,0,0,0,0,1,1,0,1,1,0,6,5,1,0,,8,0,8,7,0,7
23/01/2023 01:00,0,0,0,1,1,0,0,0,0,0,0,0,0,0,0,0,0,0,0,0,0,2,1,1,0,,3,0,3,1,0,1
23/01/2023 02:00,1,0,1,0,0,0,0,0,0,0,0,0,0,0,0,0,0,0,0,0,0,4,1,3,0,,4,0,4,0,0,0
23/01/2023 03:00,0,0,0,2,1,1,2,0,2,0,0,0,0,0,0,0,0,0,0,0,0,2,1,1,0,,1,0,1,0,0,0
23/01/2023 04:00,0,0,0,0,0,0,0,0,0,0,0,0,0,0,0,1,1,0,0,0,0,4,0,4,0,,0,0,0,2,0,2
23/01/2023 05:00,4,4,0,4,2,2,4,2,2,0,0,0,2,2,0,0,0,0,0,0,0,21,4,17,0,,2,0,2,9,0,9
23/01/2023 06:00,12,9,3,13,9,4,22,17,5,0,0,0,7,7,0,6,6,0,0,0,0,111,25,86,0,,9,0,9,22,0,22
23/01/2023 07:00,41,32,9,57,49,8,64,52,12,0,0,0,19,19,0,16,16,0,1,1,0,252,57,195,0,,20,0,20,58,0,58
23/01/2023 08:00,92,83,9,72,56,16,93,78,15,0,0,0,50,50,0,40,40,0,28,28,0,539,103,436,0,,61,0,61,171,0,171
23/01/2023 09:00,32,27,5,35,24,11,49,33,16,0,0,0,36,36,0,15,15,0,3,3,0,220,45,175,0,,39,0,39,137,0,137
23/01/2023 10:00,18,16,2,47,22,25,53,21,32,0,0,0,10,10,0,6,6,0,0,0,0,71,17,54,0,,30,1,29,64,0,64
23/01/2023 11:00,3,1,2,52,24,28,63,30,33,0,0,0,8,8,0,8,8,0,0,0,0,78,27,51,0,,39,0,39,63,0,63
23/01/2023 12:00,10,7,3,57,32,25,69,35,34,0,0,0,5,5,0,5,5,0,0,0,0,79,30,49,0,,63,0,63,63,1,62
23/01/2023 13:00,11,7,4,60,29,31,60,25,35,0,0,0,3,3,0,9,9,0,0,0,0,112,50,62,0,,78,0,78,74,1,73
23/01/2023 14:00,15,9,6,36,14,22,46,15,31,0,0,0,2,2,0,18,18,0,0,0,0,92,37,55,0,,81,1,80,65,1,64
23/01/2023 15:00,14,9,5,23,10,13,48,24,24,0,0,0,6,6,0,35,35,0,0,0,0,138,80,58,0,,64,2,62,45,0,45
23/01/2023 16:00,26,9,17,42,20,22,61,22,39,0,0,0,2,2,0,37,37,0,0,0,0,228,142,86,0,,141,0,141,50,0,50
23/01/2023 17:00,50,9,41,80,22,58,107,21,86,0,0,0,5,5,0,42,42,0,1,1,0,364,238,126,0,,231,1,230,106,0,106
23/01/2023 18:00,34,14,20,76,16,60,103,19,84,0,0,0,4,4,0,25,25,0,1,1,0,325,209,116,0,,194,0,194,97,0,97
23/01/2023 19:00,15,7,8,27,9,18,48,13,35,0,0,0,6,6,0,15,15,0,0,0,0,151,93,58,0,,136,0,136,101,0,101
23/01/2023 20:00,9,4,5,22,9,13,33,13,20,0,0,0,2,2,0,12,12,0,0,0,0,115,69,46,0,,90,1,89,51,1,50
23/01/2023 21:00,8,6,2,8,2,6,16,4,12,0,0,0,5,5,0,6,6,0,0,0,0,68,49,19,0,,55,0,55,36,0,36
23/01/2023 22:00,7,2,5,3,1,2,9,1,8,0,0,0,2,2,0,4,4,0,1,1,0,37,27,10,0,,43,0,43,24,0,24
23/01/2023 23:00,0,0,0,1,0,1,1,0,1,0,0,0,0,0,0,0,0,0,0,0,0,25,17,8,0,,24,0,24,15,2,13
24/01/2023 00:00,2,0,2,0,0,0,0,0,0,0,0,0,2,2,0,0,0,0,0,0,0,6,5,1,0,,20,0,20,10,0,10
24/01/2023 01:00,0,0,0,1,1,0,1,0,1,0,0,0,0,0,0,1,1,0,0,0,0,4,2,2,0,,0,0,0,0,0,0
24/01/2023 02:00,0,0,0,1,1,0,1,1,0,0,0,0,0,0,0,0,0,0,0,0,0,2,0,2,0,,6,1,5,3,0,3
24/01/2023 03:00,1,1,0,1,1,0,2,0,2,0,0,0,0,0,0,0,0,0,0,0,0,5,3,2,0,,6,0,6,1,0,1
24/01/2023 04:00,1,1,0,1,1,0,2,1,1,0,0,0,2,2,0,0,0,0,1,1,0,3,0,3,0,,1,0,1,1,0,1
24/01/2023 05:00,3,3,0,3,1,2,3,1,2,0,0,0,0,0,0,1,1,0,3,3,0,25,2,23,0,,4,0,4,4,0,4
24/01/2023 06:00,10,9,1,23,18,5,25,18,7,0,0,0,6,6,0,10,10,0,0,0,0,122,29,93,0,,7,0,7,21,0,21
24/01/2023 07:00,43,38,5,61,52,9,74,62,12,0,0,0,14,14,0,19,19,0,0,0,0,331,74,257,0,,29,0,29,76,0,76
24/01/2023 08:00,141,125,16,109,89,20,130,106,24,0,0,0,88,88,0,54,54,0,4,4,0,750,110,640,0,,65,1,64,183,2,181
24/01/2023 09:00,61,51,10,43,24,19,64,42,22,0,0,0,48,48,0,10,10,0,2,2,0,247,48,199,0,,35,0,35,151,0,151
24/01/2023 10:00,14,11,3,52,24,28,58,27,31,0,0,0,11,11,0,13,13,0,1,1,0,89,21,68,0,,36,1,35,47,0,47
24/01/2023 11:00,8,7,1,73,36,37,65,27,38,0,0,0,5,5,0,15,15,0,1,1,0,74,24,50,0,,28,0,28,60,0,60
24/01/2023 12:00,6,4,2,80,38,42,85,36,49,0,0,0,8,8,0,11,11,0,0,0,0,87,31,56,0,,52,0,52,80,1,79
24/01/2023 13:00,21,11,10,57,29,28,14,7,7,0,0,0,4,4,0,9,9,0,1,1,0,111,43,68,0,,94,0,94,83,1,82
24/01/2023 14:00,19,9,10,50,23,27,57,21,36,0,0,0,4,4,0,26,26,0,0,0,0,112,48,64,0,,66,0,66,75,0,75
24/01/2023 15:00,21,9,12,66,25,41,77,27,50,0,0,0,3,3,0,28,28,0,2,2,0,152,79,73,0,,75,0,75,64,0,64
24/01/2023 16:00,29,12,17,73,28,45,101,36,65,0,0,0,2,2,0,39,39,0,0,0,0,236,159,77,0,,148,0,148,80,0,80
24/01/2023 17:00,64,16,48,98,21,77,131,31,100,0,0,0,2,2,0,46,46,0,1,1,0,447,297,150,0,,288,0,288,87,1,86
24/01/2023 18:00,42,12,30,86,23,63,122,32,90,0,0,0,6,6,0,39,39,0,0,0,0,388,263,125,0,,222,1,221,113,0,113
24/01/2023 19:00,24,13,11,39,7,32,58,19,39,0,0,0,2,2,0,21,21,0,0,0,0,198,122,76,0,,155,0,155,92,0,92
24/01/2023 20:00,14,5,9,21,13,8,27,10,17,0,0,0,2,2,0,17,17,0,1,1,0,147,99,48,0,,117,0,117,85,0,85
24/01/2023 21:00,7,2,5,17,4,13,23,5,18,0,0,0,7,7,0,7,7,0,3,3,0,74,48,26,0,,72,0,72,50,0,50
24/01/2023 22:00,8,3,5,6,2,4,12,7,5,0,0,0,4,4,0,2,2,0,1,1,0,73,47,26,0,,45,0,45,35,0,35
24/01/2023 23:00,5,1,4,3,2,1,7,3,4,0,0,0,0,0,0,2,2,0,3,3,0,20,16,4,0,,39,1,38,16,0,16
25/01/2023 00:00,2,0,2,4,2,2,6,2,4,0,0,0,2,2,0,2,2,0,0,0,0,13,11,2,0,,17,0,17,10,0,10
25/01/2023 01:00,2,1,1,0,0,0,0,0,0,0,0,0,0,0,0,0,0,0,0,0,0,4,2,2,0,,3,0,3,0,0,0
25/01/2023 02:00,1,0,1,0,0,0,0,0,0,0,0,0,1,1,0,1,1,0,0,0,0,0,0,0,0,,1,0,1,1,0,1
25/01/2023 03:00,0,0,0,2,1,1,2,0,2,0,0,0,0,0,0,0,0,0,0,0,0,3,0,3,0,,2,0,2,4,0,4
25/01/2023 04:00,0,0,0,0,0,0,0,0,0,0,0,0,2,2,0,1,1,0,3,3,0,4,0,4,0,,2,0,2,1,0,1
25/01/2023 05:00,2,2,0,3,2,1,5,1,4,0,0,0,3,3,0,0,0,0,1,1,0,22,1,21,0,,2,0,2,11,0,11
25/01/2023 06:00,16,15,1,13,11,2,16,13,3,0,0,0,15,15,0,9,9,0,1,1,0,120,25,95,0,,11,0,11,29,0,29
25/01/2023 07:00,47,41,6,62,50,12,80,64,16,0,0,0,37,37,0,18,18,0,0,0,0,317,64,253,0,,28,0,28,82,1,81
25/01/2023 08:00,118,104,14,87,75,12,130,113,17,0,0,0,96,96,0,48,48,0,0,0,0,689,106,583,0,,48,0,48,201,0,201
25/01/2023 09:00,43,36,7,33,21,12,52,30,22,0,0,0,55,55,0,18,18,0,0,0,0,263,46,217,0,,24,0,24,177,0,177
25/01/2023 10:00,17,11,6,36,14,22,42,20,22,0,0,0,15,15,0,10,10,0,0,0,0,84,22,62,0,,32,0,32,57,0,57
25/01/2023 11:00,7,5,2,29,15,14,28,13,15,0,0,0,7,7,0,10,10,0,0,0,0,77,21,56,0,,34,0,34,53,0,53
25/01/2023 12:00,12,7,5,26,11,15,28,11,17,0,0,0,3,3,0,10,10,0,0,0,0,80,40,40,0,,71,0,71,67,0,67
25/01/2023 13:00,17,10,7,40,20,20,55,23,32,0,0,0,1,1,0,23,23,0,0,0,0,130,55,75,0,,76,0,76,91,1,90
25/01/2023 14:00,13,6,7,35,13,22,46,14,32,0,0,0,1,1,0,13,13,0,0,0,0,104,56,48,0,,90,1,89,87,0,87
25/01/2023 15:00,24,12,12,42,17,25,52,18,34,0,0,0,0,0,0,34,34,0,0,0,0,152,77,75,0,,74,1,73,84,1,83
25/01/2023 16:00,28,9,19,55,24,31,77,22,55,0,0,0,4,4,0,36,36,0,0,0,0,218,140,78,0,,136,2,134,76,0,76
25/01/2023 17:00,60,18,42,76,16,60,117,26,91,0,0,0,5,5,0,37,37,0,0,0,0,432,296,136,0,,240,0,240,85,1,84
25/01/2023 18:00,37,10,27,88,19,69,112,23,89,0,0,0,4,4,0,28,28,0,0,0,0,363,246,117,0,,206,1,205,122,0,122
25/01/2023 19:00,23,6,17,27,5,22,46,16,30,0,0,0,3,3,0,14,14,0,0,0,0,192,114,78,0,,183,0,183,97,0,97
25/01/2023 20:00,14,8,6,21,9,12,34,15,19,0,0,0,3,3,0,16,16,0,0,0,0,145,100,45,0,,102,1,101,86,1,85
25/01/2023 21:00,7,1,6,14,8,6,12,5,7,0,0,0,3,3,0,9,9,0,0,0,0,83,56,27,0,,78,0,78,54,1,53
25/01/2023 22:00,5,4,1,5,1,4,14,3,11,0,0,0,3,3,0,11,11,0,0,0,0,59,42,17,0,,46,1,45,45,0,45
25/01/2023 23:00,3,0,3,8,6,2,6,3,3,0,0,0,2,2,0,1,1,0,0,0,0,19,16,3,0,,36,0,36,25,0,25
26/01/2023 00:00,0,0,0,0,0,0,2,1,1,0,0,0,0,0,0,3,3,0,1,1,0,14,10,4,0,,17,0,17,13,0,13
26/01/2023 01:00,0,0,0,3,2,1,0,0,0,0,0,0,0,0,0,1,1,0,0,0,0,8,5,3,0,,0,0,0,0,0,0
26/01/2023 02:00,0,0,0,0,0,0,2,2,0,0,0,0,0,0,0,0,0,0,0,0,0,3,2,1,0,,3,0,3,2,0,2
26/01/2023 03:00,0,0,0,1,1,0,4,1,3,0,0,0,0,0,0,0,0,0,0,0,0,3,1,2,0,,4,0,4,1,0,1
26/01/2023 04:00,0,0,0,1,0,1,1,0,1,0,0,0,2,2,0,0,0,0,1,1,0,2,0,2,0,,1,0,1,1,0,1
26/01/2023 05:00,4,4,0,6,2,4,4,0,4,0,0,0,0,0,0,1,1,0,0,0,0,20,1,19,0,,2,0,2,7,0,7
26/01/2023 06:00,14,13,1,16,13,3,18,15,3,0,0,0,12,12,0,8,8,0,0,0,0,122,20,102,0,,8,0,8,23,0,23
26/01/2023 07:00,37,34,3,54,44,10,69,55,14,0,0,0,32,32,0,17,17,0,1,1,0,298,55,243,0,,30,1,29,80,0,80
26/01/2023 08:00,111,102,9,96,84,12,124,106,18,0,0,0,74,73,1,61,61,0,46,46,0,660,116,544,0,,56,1,55,220,1,219
26/01/2023 09:00,36,29,7,41,27,14,62,36,26,0,0,0,51,51,0,17,17,0,21,21,0,260,33,227,0,,35,1,34,165,0,165
26/01/2023 10:00,13,10,3,41,18,23,38,17,21,0,0,0,16,16,0,5,5,0,8,8,0,97,21,76,0,,33,0,33,64,0,64
26/01/2023 11:00,17,13,4,66,40,26,74,36,38,0,0,0,5,5,0,6,6,0,6,6,0,94,25,69,0,,40,0,40,64,0,64
26/01/2023 12:00,20,13,7,49,25,24,57,24,33,0,0,0,3,3,0,9,9,0,2,2,0,92,30,62,0,,67,0,67,79,0,79
26/01/2023 13:00,14,7,7,49,23,26,62,26,36,0,0,0,5,5,0,20,20,0,0,0,0,115,52,63,0,,82,0,82,96,0,96
26/01/2023 14:00,14,11,3,51,27,24,52,26,26,0,0,0,2,2,0,18,18,0,0,0,0,109,56,53,0,,91,1,90,64,0,64
26/01/2023 15:00,13,7,6,49,20,29,60,24,36,0,0,0,1,1,0,61,61,0,0,0,0,139,69,70,0,,79,0,79,65,0,65
26/01/2023 16:00,37,10,27,49,17,32,70,24,46,0,0,0,3,3,0,31,31,0,0,0,0,216,140,76,0,,134,0,134,68,0,68
26/01/2023 17:00,50,14,36,85,21,64,127,26,101,0,0,0,5,4,1,35,35,0,5,5,0,429,300,129,0,,229,0,229,120,0,120
26/01/2023 18:00,34,16,18,87,21,66,125,26,99,0,0,0,5,5,0,30,30,0,3,3,0,334,204,130,0,,198,0,198,126,1,125
26/01/2023 19:00,21,12,9,34,7,27,56,17,39,0,0,0,1,1,0,15,15,0,1,1,0,207,124,83,0,,127,0,127,109,0,109
26/01/2023 20:00,12,6,6,33,10,23,53,18,35,0,0,0,0,0,0,14,14,0,0,0,0,136,69,67,0,,91,0,91,100,1,99
26/01/2023 21:00,7,2,5,13,7,6,20,6,14,0,0,0,4,3,1,9,9,0,1,1,0,92,62,30,0,,83,0,83,68,1,67
26/01/2023 22:00,5,1,4,9,5,4,15,5,10,0,0,0,4,4,0,8,8,0,1,1,0,69,47,22,0,,50,0,50,46,1,45
26/01/2023 23:00,4,1,3,4,1,3,6,1,5,0,0,0,2,2,0,1,1,0,0,0,0,43,37,6,0,,56,0,56,25,0,25
27/01/2023 00:00,1,0,1,1,0,1,3,1,2,0,0,0,2,2,0,1,1,0,0,0,0,25,18,7,0,,30,0,30,13,1,12
27/01/2023 01:00,0,0,0,2,1,1,1,0,1,0,0,0,1,1,0,1,1,0,0,0,0,9,7,2,0,,3,0,3,0,0,0
27/01/2023 02:00,1,0,1,2,2,0,2,2,0,0,0,0,0,0,0,0,0,0,0,0,0,3,3,0,0,,13,0,13,3,0,3
27/01/2023 03:00,1,1,0,1,1,0,2,0,2,0,0,0,1,1,0,1,1,0,0,0,0,5,2,3,0,,5,0,5,3,0,3
27/01/2023 04:00,0,0,0,1,0,1,1,0,1,0,0,0,2,2,0,0,0,0,2,2,0,3,1,2,0,,6,1,5,2,0,2
27/01/2023 05:00,3,3,0,2,1,1,3,1,2,0,0,0,1,1,0,0,0,0,0,0,0,30,5,25,0,,1,0,1,10,0,10
27/01/2023 06:00,11,11,0,14,9,5,15,9,6,0,0,0,14,14,0,8,8,0,0,0,0,99,18,81,0,,8,0,8,21,0,21
27/01/2023 07:00,26,23,3,31,25,6,33,31,2,0,0,0,23,23,0,11,11,0,3,3,0,186,54,132,0,,28,0,28,49,0,49
27/01/2023 08:00,87,77,10,61,44,17,71,53,18,0,0,0,25,25,0,31,31,0,56,56,0,395,80,315,0,,45,1,44,131,1,130
27/01/2023 09:00,33,25,8,35,19,16,52,33,19,0,0,0,24,24,0,13,13,0,12,12,0,182,40,142,0,,40,1,39,119,0,119
27/01/2023 10:00,12,10,2,40,17,23,48,25,23,0,0,0,8,8,0,3,3,0,3,3,0,86,10,76,0,,37,1,36,64,0,64
27/01/2023 11:00,4,2,2,51,23,28,61,29,32,0,0,0,15,15,0,3,3,0,7,7,0,70,21,49,0,,34,0,34,63,0,63
27/01/2023 12:00,17,13,4,54,30,24,60,27,33,0,0,0,8,8,0,17,17,0,12,12,0,106,35,71,0,,89,2,87,110,2,108
27/01/2023 13:00,16,8,8,36,19,17,38,18,20,0,0,0,10,10,0,23,23,0,8,8,0,141,65,76,0,,85,0,85,114,0,114
27/01/2023 14:00,16,10,6,38,14,24,57,18,39,0,0,0,11,11,0,23,23,0,3,3,0,133,63,70,0,,90,0,90,83,0,83
27/01/2023 15:00,14,9,5,37,20,17,59,26,33,0,0,0,10,10,0,27,27,0,10,10,0,160,84,76,0,,71,0,71,74,0,74
27/01/2023 16:00,34,15,19,58,22,36,85,29,56,0,0,0,12,12,0,30,30,0,14,14,0,204,120,84,0,,135,0,135,90,0,90
27/01/2023 17:00,39,7,32,60,20,40,85,26,59,0,0,0,2,2,0,25,25,0,8,8,0,312,194,118,0,,182,0,182,128,1,127
27/01/2023 18:00,19,6,13,47,14,33,62,15,47,0,0,0,0,0,0,17,17,0,2,2,0,246,125,121,0,,184,0,184,118,1,117
27/01/2023 19:00,11,5,6,26,5,21,37,8,29,0,0,0,4,4,0,22,22,0,11,11,0,164,82,82,0,,131,0,131,99,0,99
27/01/2023 20:00,16,6,10,3,0,3,11,3,8,0,0,0,1,1,0,9,9,0,0,0,0,100,59,41,0,,85,1,84,79,0,79
27/01/2023 21:00,8,5,3,3,0,3,8,3,5,0,0,0,0,0,0,4,4,0,1,1,0,91,52,39,0,,74,1,73,82,1,81
27/01/2023 22:00,7,3,4,2,1,1,10,5,5,0,0,0,2,2,0,5,5,0,1,1,0,61,34,27,0,,59,0,59,58,0,58
27/01/2023 23:00,2,2,0,5,2,3,4,2,2,0,0,0,1,1,0,1,1,0,3,3,0,49,29,20,0,,48,1,47,31,0,31
28/01/2023 00:00,5,2,3,3,2,1,5,2,3,0,0,0,0,0,0,3,3,0,0,0,0,28,21,7,0,,35,1,34,18,0,18
28/01/2023 01:00,3,1,2,4,3,1,5,3,2,0,0,0,1,1,0,6,6,0,0,0,0,16,8,8,0,,8,0,8,2,0,2
28/01/2023 02:00,2,0,2,0,0,0,2,2,0,0,0,0,0,0,0,0,0,0,0,0,0,13,11,2,0,,16,0,16,3,0,3
28/01/2023 03:00,0,0,0,0,0,0,0,0,0,0,0,0,0,0,0,0,0,0,0,0,0,13,9,4,0,,6,0,6,2,1,1
28/01/2023 04:00,2,1,1,0,0,0,1,0,1,0,0,0,0,0,0,1,1,0,0,0,0,13,9,4,0,,11,0,11,6,0,6
28/01/2023 05:00,1,0,1,2,0,2,4,2,2,0,0,0,0,0,0,1,1,0,0,0,0,5,2,3,0,,2,0,2,3,0,3
28/01/2023 06:00,3,3,0,4,3,1,5,4,1,0,0,0,3,3,0,2,2,0,0,0,0,32,8,24,0,,1,0,1,5,0,5
28/01/2023 07:00,7,7,0,19,7,12,15,6,9,0,0,0,5,5,0,2,2,0,2,2,0,36,10,26,0,,9,0,9,13,0,13
28/01/2023 08:00,6,3,3,44,18,26,35,19,16,0,0,0,4,4,0,5,5,0,2,2,0,55,14,41,0,,16,0,16,33,0,33
28/01/2023 09:00,8,6,2,89,47,42,87,39,48,0,0,0,11,11,0,18,18,0,0,0,0,92,35,57,0,,19,0,19,62,1,61
28/01/2023 10:00,6,5,1,111,44,67,111,38,73,0,0,0,10,10,0,14,14,0,1,1,0,83,30,53,0,,45,0,45,53,0,53
28/01/2023 11:00,9,8,1,103,49,54,124,61,63,0,0,0,1,1,0,6,6,0,0,0,0,85,24,61,0,,46,0,46,65,0,65
28/01/2023 12:00,8,6,2,107,61,46,135,74,61,0,0,0,0,0,0,14,14,0,6,6,0,111,49,62,0,,63,0,63,89,2,87
28/01/2023 13:00,23,12,11,77,47,30,103,53,50,0,0,0,5,5,0,14,14,0,5,5,0,118,52,66,0,,79,0,79,94,0,94
28/01/2023 14:00,6,2,4,54,24,30,75,31,44,0,0,0,1,1,0,8,8,0,5,5,0,117,51,66,0,,60,0,60,78,0,78
28/01/2023 15:00,10,6,4,55,27,28,80,44,36,0,0,0,4,4,0,8,8,0,0,0,0,120,48,72,0,,54,0,54,89,0,89
28/01/2023 16:00,14,8,6,45,23,22,62,34,28,0,0,0,3,3,0,10,10,0,2,2,0,108,34,74,0,,81,0,81,64,0,64
28/01/2023 17:00,4,1,3,20,10,10,26,16,10,0,0,0,0,0,0,7,7,0,1,1,0,110,51,59,0,,93,0,93,53,1,52
28/01/2023 18:00,3,1,2,12,5,7,27,9,18,0,0,0,1,1,0,8,8,0,1,1,0,127,48,79,0,,64,2,62,78,0,78
28/01/2023 19:00,9,3,6,13,6,7,17,6,11,0,0,0,1,1,0,2,2,0,0,0,0,83,35,48,0,,74,1,73,80,1,79
28/01/2023 20:00,6,2,4,4,2,2,9,4,5,0,0,0,3,3,0,4,4,0,0,0,0,72,33,39,0,,53,0,53,70,1,69
28/01/2023 21:00,0,0,0,1,0,1,4,3,1,0,0,0,5,5,0,3,3,0,0,0,0,54,21,33,0,,43,1,42,65,0,65
28/01/2023 22:00,5,3,2,1,0,1,1,0,1,0,0,0,1,1,0,2,2,0,2,2,0,56,37,19,0,,30,0,30,40,0,40
28/01/2023 23:00,0,0,0,2,1,1,3,1,2,0,0,0,0,0,0,1,1,0,1,1,0,38,20,18,0,,27,1,26,27,0,27
29/01/2023 00:00,1,0,1,4,1,3,4,1,3,0,0,0,0,0,0,0,0,0,5,5,0,32,19,13,0,,18,0,18,11,0,11
29/01/2023 01:00,0,0,0,3,3,0,2,0,2,0,0,0,1,1,0,2,2,0,0,0,0,8,7,1,0,,2,0,2,1,0,1
29/01/2023 02:00,1,0,1,1,0,1,0,0,0,0,0,0,0,0,0,0,0,0,0,0,0,8,5,3,0,,16,0,16,4,1,3
29/01/2023 03:00,0,0,0,0,0,0,1,0,1,0,0,0,1,1,0,1,1,0,0,0,0,4,3,1,0,,8,0,8,4,0,4
29/01/2023 04:00,1,0,1,0,0,0,1,0,1,0,0,0,0,0,0,0,0,0,0,0,0,6,6,0,0,,12,0,12,4,0,4
29/01/2023 05:00,1,0,1,1,0,1,1,0,1,0,0,0,0,0,0,0,0,0,0,0,0,9,6,3,0,,6,0,6,3,1,2
29/01/2023 06:00,2,1,1,4,3,1,4,3,1,0,0,0,1,1,0,0,0,0,0,0,0,18,6,12,0,,3,0,3,8,0,8
29/01/2023 07:00,2,1,1,18,8,10,15,5,10,0,0,0,5,5,0,1,1,0,0,0,0,15,5,10,0,,4,0,4,6,0,6
29/01/2023 08:00,5,5,0,55,24,31,69,30,39,0,0,0,6,6,0,7,7,0,0,0,0,47,15,32,0,,6,0,6,10,0,10
29/01/2023 09:00,6,5,1,102,43,59,95,38,57,0,0,0,6,6,0,7,7,0,0,0,0,49,12,37,0,,17,0,17,34,0,34
29/01/2023 10:00,13,10,3,140,47,93,122,45,77,0,0,0,7,7,0,5,5,0,0,0,0,52,25,27,0,,25,0,25,39,0,39
29/01/2023 11:00,9,5,4,142,77,65,156,72,84,0,0,0,7,7,0,16,16,0,1,1,0,80,29,51,0,,33,0,33,45,0,45
29/01/2023 12:00,9,6,3,151,71,80,146,68,78,0,0,0,8,8,0,20,20,0,6,6,0,91,34,57,0,,40,0,40,61,0,61
29/01/2023 13:00,9,5,4,85,47,38,118,60,58,0,0,0,3,3,0,11,11,0,4,4,0,85,38,47,0,,61,1,60,58,1,57
29/01/2023 14:00,13,8,5,84,38,46,87,41,46,0,0,0,0,0,0,8,8,0,0,0,0,105,39,66,0,,53,0,53,74,0,74
29/01/2023 15:00,11,6,5,75,43,32,86,42,44,0,0,0,1,1,0,12,12,0,1,1,0,101,39,62,0,,56,0,56,78,0,78
29/01/2023 16:00,8,3,5,47,33,14,85,47,38,0,0,0,2,2,0,9,9,0,0,0,0,85,36,49,0,,77,0,77,56,0,56
29/01/2023 17:00,8,6,2,27,12,15,47,28,19,0,0,0,0,0,0,7,7,0,0,0,0,107,49,58,0,,74,1,73,60,0,60
29/01/2023 18:00,4,1,3,17,9,8,29,13,16,0,0,0,1,1,0,8,8,0,0,0,0,106,45,61,0,,83,2,81,70,2,68
29/01/2023 19:00,10,7,3,9,4,5,21,9,12,0,0,0,2,2,0,14,14,0,0,0,0,78,42,36,0,,72,0,72,86,0,86
29/01/2023 20:00,12,5,7,3,0,3,12,3,9,0,0,0,0,0,0,3,3,0,0,0,0,64,34,30,0,,47,1,46,54,0,54
29/01/2023 21:00,3,1,2,6,5,1,9,4,5,0,0,0,1,1,0,4,4,0,4,4,0,41,17,24,0,,43,1,42,50,0,50
29/01/2023 22:00,2,2,0,4,3,1,2,1,1,0,0,0,0,0,0,3,3,0,1,1,0,33,25,8,0,,32,0,32,25,0,25
29/01/2023 23:00,3,2,1,0,0,0,3,2,1,0,0,0,0,0,0,2,2,0,0,0,0,24,16,8,0,,24,0,24,12,0,12
30/01/2023 00:00,2,0,2,0,0,0,1,1,0,0,0,0,2,2,0,3,3,0,0,0,0,7,6,1,0,,17,0,17,7,0,7
30/01/2023 01:00,3,2,1,2,2,0,1,0,1,0,0,0,0,0,0,0,0,0,0,0,0,2,2,0,0,,2,1,1,1,0,1
30/01/2023 02:00,1,0,1,0,0,0,0,0,0,0,0,0,0,0,0,0,0,0,0,0,0,2,2,0,0,,2,0,2,4,0,4
30/01/2023 03:00,0,0,0,1,1,0,1,0,1,0,0,0,1,1,0,0,0,0,0,0,0,2,1,1,0,,4,0,4,0,0,0
30/01/2023 04:00,1,0,1,0,0,0,1,0,1,0,0,0,0,0,0,0,0,0,0,0,0,8,2,6,0,,0,0,0,2,0,2
30/01/2023 05:00,0,0,0,5,2,3,5,2,3,0,0,0,1,1,0,2,2,0,0,0,0,21,4,17,0,,4,0,4,12,0,12
30/01/2023 06:00,11,10,1,12,11,1,19,14,5,0,0,0,12,12,0,6,6,0,1,1,0,122,25,97,0,,9,0,9,18,0,18
30/01/2023 07:00,27,23,4,45,35,10,55,44,11,0,0,0,39,39,0,18,18,0,13,13,0,273,64,209,0,,29,0,29,65,0,65
30/01/2023 08:00,93,83,10,70,60,10,96,83,13,0,0,0,68,67,1,36,36,0,89,89,0,524,96,428,0,,47,0,47,168,0,168
30/01/2023 09:00,31,26,5,46,31,15,63,48,15,0,0,0,15,15,0,14,14,0,3,3,0,207,29,178,0,,39,0,39,103,0,103
30/01/2023 10:00,12,10,2,47,21,26,48,28,20,0,0,0,4,4,0,8,8,0,0,0,0,32,27,5,0,,28,0,28,68,1,67
30/01/2023 11:00,10,3,7,49,22,27,55,26,29,0,0,0,6,6,0,11,11,0,0,0,0,33,15,18,0,,22,1,21,60,0,60
30/01/2023 12:00,12,10,2,55,21,34,56,22,34,0,0,0,14,13,1,11,11,0,0,0,0,86,29,57,0,,54,1,53,75,0,75
30/01/2023 13:00,13,5,8,64,31,33,63,27,36,0,0,0,6,6,0,11,11,0,2,2,0,103,47,56,0,,57,1,56,80,1,79
30/01/2023 14:00,20,14,6,41,19,22,42,16,26,0,0,0,3,3,0,10,10,0,14,14,0,112,49,63,0,,68,0,68,72,0,72
30/01/2023 15:00,22,11,11,32,18,14,39,21,18,0,0,0,9,8,1,38,38,0,9,9,0,140,78,62,0,,76,1,75,58,0,58
30/01/2023 16:00,31,13,18,51,18,33,62,24,38,0,0,0,2,2,0,43,43,0,19,19,0,221,138,83,0,,125,1,124,68,0,68
30/01/2023 17:00,46,16,30,75,15,60,110,30,80,0,0,0,1,1,0,39,39,0,0,0,0,372,246,126,0,,224,0,224,117,4,113
30/01/2023 18:00,28,6,22,77,15,62,102,22,80,0,0,0,3,3,0,25,25,0,0,0,0,323,208,115,0,,216,2,214,96,0,96
30/01/2023 19:00,19,9,10,40,10,30,56,15,41,0,0,0,6,6,0,15,15,0,0,0,0,154,104,50,0,,125,0,125,80,0,80
30/01/2023 20:00,9,4,5,10,3,7,15,6,9,0,0,0,2,2,0,4,4,0,0,0,0,100,61,39,0,,107,0,107,56,1,55
30/01/2023 21:00,8,6,2,6,2,4,20,8,12,0,0,0,2,2,0,14,14,0,0,0,0,62,41,21,0,,67,0,67,38,0,38
30/01/2023 22:00,6,3,3,4,0,4,11,2,9,0,0,0,0,0,0,7,7,0,2,2,0,48,37,11,0,,41,0,41,29,0,29
30/01/2023 23:00,7,6,1,3,1,2,7,3,4,0,0,0,0,0,0,2,2,0,3,3,0,15,11,4,0,,18,0,18,6,0,6
31/01/2023 00:00,0,0,0,1,0,1,1,0,1,0,0,0,0,0,0,1,1,0,1,1,0,8,5,3,0,,13,0,13,7,0,7
31/01/2023 01:00,0,0,0,3,2,1,1,0,1,0,0,0,0,0,0,1,1,0,0,0,0,5,3,2,0,,1,0,1,0,0,0
31/01/2023 02:00,0,0,0,0,0,0,0,0,0,0,0,0,0,0,0,0,0,0,0,0,0,1,1,0,0,,4,0,4,2,0,2
31/01/2023 03:00,2,0,2,1,1,0,2,0,2,0,0,0,0,0,0,0,0,0,0,0,0,0,0,0,0,,2,0,2,3,1,2
31/01/2023 04:00,0,0,0,0,0,0,0,0,0,0,0,0,3,3,0,0,0,0,0,0,0,6,1,5,0,,1,0,1,2,0,2
31/01/2023 05:00,3,3,0,6,2,4,5,1,4,0,0,0,2,2,0,1,1,0,1,1,0,29,5,24,0,,2,0,2,12,0,12
31/01/2023 06:00,17,16,1,21,17,4,25,19,6,0,0,0,15,15,0,6,6,0,1,1,0,115,23,92,0,,15,0,15,32,0,32
31/01/2023 07:00,46,37,9,54,45,9,66,51,15,0,0,0,39,39,0,24,24,0,0,0,0,328,59,269,0,,34,0,34,85,0,85
31/01/2023 08:00,131,118,13,83,72,11,107,95,12,0,0,0,57,57,0,46,46,0,1,1,0,695,103,592,0,,48,0,48,225,0,225
31/01/2023 09:00,43,34,9,31,23,8,45,31,14,0,0,0,30,30,0,19,19,0,0,0,0,236,40,196,0,,39,1,38,161,0,161
31/01/2023 10:00,12,6,6,26,11,15,36,13,23,0,0,0,6,6,0,11,11,0,2,2,0,91,23,68,0,,35,0,35,73,0,73
31/01/2023 11:00,14,8,6,28,13,15,33,14,19,0,0,0,9,9,0,13,13,0,1,1,0,99,32,67,0,,40,0,40,62,0,62
31/01/2023 12:00,20,12,8,34,14,20,37,13,24,0,0,0,7,7,0,11,11,0,3,3,0,97,36,61,0,,55,0,55,74,0,74
31/01/2023 13:00,7,4,3,35,17,18,36,11,25,0,0,0,3,3,0,14,14,0,0,0,0,91,31,60,0,,70,0,70,78,0,78
31/01/2023 14:00,17,7,10,21,7,14,25,8,17,0,0,0,3,3,0,15,15,0,0,0,0,115,48,67,0,,49,0,49,48,0,48
31/01/2023 15:00,16,8,8,29,12,17,35,7,28,0,0,0,9,9,0,44,44,0,1,1,0,140,75,65,0,,69,0,69,65,0,65
31/01/2023 16:00,38,11,27,46,13,33,66,22,44,0,0,0,6,6,0,41,41,0,0,0,0,218,145,73,0,,123,0,123,74,0,74
31/01/2023 17:00,77,18,59,89,14,75,128,18,110,0,0,0,3,3,0,42,42,0,0,0,0,426,292,134,0,,227,3,224,112,0,112
31/01/2023 18:00,34,7,27,75,14,61,101,17,84,0,0,0,0,0,0,38,38,0,0,0,0,349,240,109,0,,222,0,222,105,0,105
31/01/2023 19:00,25,11,14,37,9,28,43,12,31,0,0,0,3,3,0,25,25,0,0,0,0,201,135,66,0,,148,0,148,82,0,82
31/01/2023 20:00,14,6,8,15,5,10,28,12,16,0,0,0,1,1,0,9,9,0,2,2,0,134,87,47,0,,88,1,87,77,1,76
31/01/2023 21:00,8,2,6,12,6,6,11,2,9,0,0,0,6,5,1,14,14,0,1,1,0,82,53,29,0,,56,0,56,46,0,46
31/01/2023 22:00,10,6,4,6,1,5,11,3,8,0,0,0,2,2,0,6,6,0,0,0,0,51,36,15,0,,42,0,42,33,1,32
31/01/2023 23:00,5,2,3,3,1,2,1,0,1,0,0,0,2,2,0,1,1,0,0,0,0,16,12,4,0,,24,0,24,24,0,24
1/2/2023 0:00,0,0,0,2,2,0,3,2,1,0,0,0,1,1,0,0,0,0,2,2,0,10,8,2,0,,20,0,20,10,0,10
1/2/2023 1:00,1,0,1,1,1,0,0,0,0,0,0,0,0,0,0,0,0,0,0,0,0,8,8,0,0,,6,0,6,1,0,1
1/2/2023 2:00,0,0,0,1,0,1,1,0,1,0,0,0,0,0,0,0,0,0,0,0,0,3,3,0,0,,4,0,4,4,0,4
1/2/2023 3:00,0,0,0,1,1,0,1,0,1,0,0,0,1,1,0,0,0,0,0,0,0,2,1,1,0,,4,0,4,4,0,4
1/2/2023 4:00,1,0,1,0,0,0,0,0,0,0,0,0,1,1,0,0,0,0,0,0,0,5,0,5,0,,1,0,1,2,0,2
1/2/2023 5:00,3,2,1,2,1,1,2,1,1,0,0,0,2,2,0,2,2,0,0,0,0,27,2,25,0,,1,0,1,8,0,8
1/2/2023 6:00,18,17,1,12,10,2,15,11,4,0,0,0,10,10,0,5,5,0,3,3,0,134,20,114,0,,4,0,4,34,0,34
1/2/2023 7:00,35,31,4,46,38,8,56,45,11,0,0,0,16,16,0,14,14,0,9,9,0,282,62,220,0,,32,0,32,81,0,81
1/2/2023 8:00,127,110,17,78,66,12,107,89,18,0,0,0,57,57,0,43,43,0,6,6,0,660,105,555,0,,47,0,47,220,3,217
1/2/2023 9:00,45,39,6,33,19,14,49,29,20,0,0,0,22,22,0,12,12,0,0,0,0,238,29,209,0,,41,0,41,149,0,149
1/2/2023 10:00,12,9,3,25,8,17,28,13,15,0,0,0,10,10,0,6,6,0,1,1,0,81,20,61,0,,33,0,33,71,0,71
1/2/2023 11:00,9,7,2,23,13,10,26,15,11,0,0,0,5,5,0,16,16,0,1,1,0,74,17,57,0,,48,1,47,46,0,46
1/2/2023 12:00,11,7,4,22,11,11,25,8,17,0,0,0,2,2,0,7,7,0,6,6,0,103,35,68,0,,71,0,71,94,0,94
1/2/2023 13:00,26,16,10,37,19,18,39,18,21,0,0,0,3,3,0,17,17,0,8,8,0,127,49,78,0,,77,0,77,89,4,85
1/2/2023 14:00,18,11,7,25,10,15,35,8,27,0,0,0,8,8,0,16,16,0,15,15,0,107,49,58,0,,55,1,54,50,0,50
1/2/2023 15:00,19,7,12,34,12,22,38,12,26,0,0,0,11,11,0,42,42,0,0,0,0,135,81,54,0,,81,1,80,73,0,73
1/2/2023 16:00,30,9,21,41,17,24,56,18,38,0,0,0,4,4,0,36,36,0,1,1,0,232,144,88,0,,135,0,135,69,1,68
1/2/2023 17:00,64,18,46,86,15,71,113,17,96,0,0,0,2,2,0,41,41,0,0,0,0,395,275,120,0,,216,0,216,117,1,116
1/2/2023 18:00,40,14,26,78,14,64,110,15,95,0,0,0,5,5,0,29,29,0,0,0,0,322,223,99,0,,196,0,196,108,1,107
1/2/2023 19:00,19,10,9,51,15,36,56,18,38,0,0,0,3,3,0,11,11,0,0,0,0,191,123,68,0,,145,0,145,100,0,100
1/2/2023 20:00,4,1,3,14,6,8,24,9,15,0,0,0,2,2,0,19,19,0,0,0,0,123,79,44,0,,91,1,90,73,1,72
1/2/2023 21:00,4,2,2,13,7,6,12,5,7,0,0,0,1,1,0,4,4,0,1,1,0,89,56,33,0,,77,0,77,63,0,63
1/2/2023 22:00,7,3,4,7,3,4,8,2,6,0,0,0,1,1,0,4,4,0,2,2,0,57,36,21,0,,40,0,40,30,0,30
1/2/2023 23:00,7,4,3,1,0,1,5,2,3,0,0,0,0,0,0,2,2,0,0,0,0,33,28,5,0,,30,0,30,19,0,19
2/2/2023 0:00,5,3,2,1,1,0,1,1,0,0,0,0,1,1,0,2,2,0,0,0,0,13,10,3,0,,14,0,14,7,0,7
2/2/2023 1:00,2,2,0,1,1,0,1,1,0,0,0,0,0,0,0,1,1,0,1,1,0,4,2,2,0,,1,0,1,2,0,2
2/2/2023 2:00,0,0,0,0,0,0,0,0,0,0,0,0,0,0,0,0,0,0,0,0,0,2,2,0,0,,10,0,10,2,0,2
2/2/2023 3:00,1,0,1,2,1,1,2,0,2,0,0,0,0,0,0,0,0,0,0,0,0,5,3,2,0,,6,0,6,2,0,2
2/2/2023 4:00,0,0,0,0,0,0,2,0,2,0,0,0,1,1,0,0,0,0,3,3,0,6,2,4,0,,2,0,2,0,0,0
2/2/2023 5:00,3,3,0,3,1,2,3,0,3,0,0,0,3,3,0,2,2,0,1,1,0,25,4,21,0,,2,0,2,8,0,8
2/2/2023 6:00,16,15,1,15,10,5,19,15,4,0,0,0,7,7,0,6,6,0,5,5,0,117,26,91,0,,8,0,8,31,1,30
2/2/2023 7:00,30,26,4,38,31,7,47,37,10,0,0,0,53,53,0,16,16,0,18,18,0,284,55,229,0,,35,0,35,73,0,73
2/2/2023 8:00,121,113,8,79,63,16,106,85,21,0,0,0,73,73,0,52,52,0,81,81,0,609,101,508,0,,62,0,62,211,0,211
2/2/2023 9:00,45,40,5,28,20,8,33,20,13,0,0,0,40,40,0,8,8,0,18,18,0,273,49,224,0,,41,0,41,145,0,145
2/2/2023 10:00,14,9,5,39,17,22,52,18,34,0,0,0,5,5,0,14,14,0,6,6,0,104,34,70,0,,33,0,33,48,0,48
2/2/2023 11:00,15,10,5,33,16,17,36,16,20,0,0,0,9,9,0,8,8,0,2,2,0,80,23,57,0,,46,1,45,71,0,71
2/2/2023 12:00,13,8,5,39,21,18,37,17,20,0,0,0,3,3,0,12,12,0,10,10,0,78,24,54,0,,65,0,65,78,0,78
2/2/2023 13:00,17,7,10,28,9,19,33,12,21,0,0,0,5,5,0,14,14,0,3,3,0,113,48,65,0,,53,0,53,92,0,92
2/2/2023 14:00,18,9,9,13,4,9,31,9,22,0,0,0,9,9,0,14,14,0,9,9,0,99,46,53,0,,79,0,79,63,0,63
2/2/2023 15:00,26,16,10,31,12,19,28,10,18,0,0,0,0,0,0,47,47,0,5,5,0,149,77,72,0,,70,1,69,69,0,69
2/2/2023 16:00,32,11,21,40,16,24,53,14,39,0,0,0,6,6,0,32,32,0,10,10,0,226,136,90,0,,128,0,128,85,0,85
2/2/2023 17:00,51,9,42,75,15,60,103,16,87,0,0,0,1,1,0,35,35,0,10,10,0,386,256,130,0,,225,1,224,98,1,97
2/2/2023 18:00,43,11,32,86,18,68,108,17,91,0,0,0,4,4,0,30,30,0,9,9,0,344,235,109,0,,170,0,170,120,0,120
2/2/2023 19:00,28,8,20,29,9,20,37,7,30,0,0,0,4,4,0,20,20,0,7,7,0,182,113,69,0,,130,0,130,84,0,84
2/2/2023 20:00,17,9,8,25,11,14,27,12,15,0,0,0,2,2,0,13,13,0,9,9,0,138,82,56,0,,85,0,85,97,1,96
2/2/2023 21:00,19,5,14,14,7,7,18,6,12,0,0,0,2,2,0,10,10,0,3,3,0,82,55,27,0,,69,0,69,56,0,56
2/2/2023 22:00,4,4,0,8,2,6,14,4,10,0,0,0,4,3,1,7,7,0,0,0,0,60,38,22,0,,45,0,45,39,1,38
2/2/2023 23:00,5,2,3,4,1,3,8,3,5,0,0,0,3,3,0,3,3,0,0,0,0,34,25,9,0,,40,0,40,30,0,30
3/2/2023 0:00,0,0,0,3,2,1,3,1,2,0,0,0,1,1,0,2,2,0,0,0,0,16,11,5,0,,26,1,25,10,0,10
3/2/2023 1:00,0,0,0,1,1,0,0,0,0,0,0,0,1,1,0,2,2,0,0,0,0,3,3,0,0,,2,0,2,0,0,0
3/2/2023 2:00,0,0,0,0,0,0,0,0,0,0,0,0,0,0,0,1,1,0,0,0,0,6,4,2,0,,5,0,5,5,0,5
3/2/2023 3:00,0,0,0,0,0,0,2,1,1,0,0,0,0,0,0,0,0,0,0,0,0,2,1,1,0,,10,1,9,2,0,2
3/2/2023 4:00,2,0,2,0,0,0,2,0,2,0,0,0,0,0,0,1,1,0,0,0,0,11,7,4,0,,7,0,7,0,0,0
3/2/2023 5:00,4,4,0,1,1,0,2,1,1,0,0,0,4,4,0,3,3,0,0,0,0,21,3,18,0,,3,0,3,9,0,9
3/2/2023 6:00,16,15,1,14,11,3,20,13,7,0,0,0,12,12,0,10,10,0,0,0,0,110,19,91,0,,9,0,9,21,0,21
3/2/2023 7:00,25,18,7,42,31,11,52,39,13,0,0,0,34,34,0,10,10,0,0,0,0,188,41,147,0,,21,0,21,55,1,54
3/2/2023 8:00,72,64,8,63,43,20,69,48,21,0,0,0,40,39,1,31,31,0,0,0,0,407,73,334,0,,42,0,42,146,0,146
3/2/2023 9:00,23,18,5,34,24,10,45,28,17,0,0,0,15,15,0,10,10,0,0,0,0,203,41,162,0,,44,0,44,113,0,113
3/2/2023 10:00,14,11,3,44,27,17,51,23,28,0,0,0,7,7,0,7,7,0,0,0,0,27,19,8,0,,32,0,32,62,0,62
3/2/2023 11:00,13,6,7,52,26,26,57,26,31,0,0,0,4,3,1,19,19,0,0,0,0,58,26,32,0,,39,0,39,75,1,74
3/2/2023 12:00,20,10,10,61,28,33,64,29,35,0,0,0,8,8,0,9,9,0,0,0,0,116,48,68,0,,75,1,74,87,0,87
3/2/2023 13:00,16,12,4,57,31,26,59,27,32,0,0,0,3,2,1,35,35,0,0,0,0,136,66,70,0,,79,0,79,109,0,109
3/2/2023 14:00,18,8,10,44,21,23,53,23,30,0,0,0,1,1,0,18,18,0,0,0,0,141,71,70,0,,93,0,93,60,0,60
3/2/2023 15:00,30,18,12,48,22,26,58,16,42,0,0,0,4,4,0,23,23,0,0,0,0,169,100,69,0,,111,1,110,80,0,80
3/2/2023 16:00,40,21,19,79,27,52,87,32,55,0,0,0,4,4,0,22,22,0,3,3,0,203,121,82,0,,139,0,139,95,0,95
3/2/2023 17:00,35,15,20,60,18,42,91,29,62,0,0,0,4,4,0,24,24,0,1,1,0,271,160,111,0,,202,0,202,113,0,113
3/2/2023 18:00,16,6,10,41,13,28,61,19,42,0,0,0,4,4,0,15,15,0,0,0,0,222,124,98,0,,134,0,134,92,1,91
3/2/2023 19:00,14,6,8,24,10,14,33,12,21,0,0,0,7,7,0,11,11,0,1,1,0,147,84,63,0,,112,1,111,112,0,112
3/2/2023 20:00,12,6,6,5,3,2,10,4,6,0,0,0,3,3,0,7,7,0,4,4,0,111,64,47,0,,101,0,101,108,0,108
3/2/2023 21:00,10,5,5,5,3,2,10,6,4,0,0,0,7,7,0,11,11,0,6,6,0,83,46,37,0,,79,3,76,75,0,75
3/2/2023 22:00,3,1,2,8,3,5,13,7,6,0,0,0,2,2,0,5,5,0,0,0,0,57,31,26,0,,47,0,47,54,0,54
3/2/2023 23:00,4,3,1,4,1,3,4,1,3,0,0,0,1,1,0,2,2,0,0,0,0,36,25,11,0,,41,0,41,26,0,26
4/2/2023 0:00,3,0,3,2,1,1,3,0,3,0,0,0,1,1,0,5,5,0,0,0,0,32,17,15,0,,25,1,24,21,0,21
4/2/2023 1:00,2,1,1,4,2,2,3,2,1,0,0,0,0,0,0,0,0,0,0,0,0,19,13,6,0,,5,0,5,1,0,1
4/2/2023 2:00,0,0,0,1,0,1,3,0,3,0,0,0,0,0,0,1,1,0,0,0,0,9,7,2,0,,16,0,16,7,0,7
4/2/2023 3:00,0,0,0,1,0,1,1,0,1,0,0,0,0,0,0,0,0,0,0,0,0,8,4,4,0,,11,0,11,2,0,2
4/2/2023 4:00,1,0,1,1,0,1,2,0,2,0,0,0,0,0,0,1,1,0,0,0,0,10,6,4,0,,14,0,14,5,0,5
4/2/2023 5:00,0,0,0,2,2,0,2,2,0,0,0,0,0,0,0,1,1,0,0,0,0,6,3,3,0,,2,0,2,2,0,2
4/2/2023 6:00,2,2,0,9,6,3,7,3,4,0,0,0,6,6,0,4,4,0,0,0,0,31,8,23,0,,2,0,2,6,0,6
4/2/2023 7:00,2,1,1,19,10,9,29,12,17,0,0,0,7,7,0,1,1,0,0,0,0,39,10,29,0,,11,0,11,9,0,9
4/2/2023 8:00,5,5,0,61,23,38,64,21,43,0,0,0,6,6,0,3,3,0,0,0,0,51,21,30,0,,12,0,12,26,0,26
4/2/2023 9:00,13,9,4,85,38,47,90,34,56,0,0,0,12,12,0,12,12,0,0,0,0,73,21,52,0,,24,0,24,53,0,53
4/2/2023 10:00,14,9,5,111,44,67,120,45,75,0,0,0,7,7,0,12,12,0,0,0,0,84,23,61,0,,33,0,33,57,0,57
4/2/2023 11:00,5,5,0,117,58,59,114,51,63,0,0,0,4,4,0,15,15,0,0,0,0,91,26,65,0,,43,0,43,75,0,75
4/2/2023 12:00,21,8,13,103,56,47,101,52,49,0,0,0,3,3,0,16,16,0,1,1,0,119,60,59,0,,56,0,56,63,0,63
4/2/2023 13:00,14,5,9,75,44,31,93,57,36,0,0,0,14,14,0,18,18,0,1,1,0,142,59,83,0,,94,0,94,99,1,98
4/2/2023 14:00,20,13,7,41,15,26,58,21,37,0,0,0,4,4,0,13,13,0,0,0,0,99,50,49,0,,65,1,64,70,1,69
4/2/2023 15:00,6,3,3,48,23,25,54,27,27,0,0,0,8,7,1,10,10,0,0,0,0,91,37,54,0,,49,0,49,70,0,70
4/2/2023 16:00,8,4,4,24,15,9,28,19,9,0,0,0,6,6,0,6,6,0,0,0,0,98,42,56,0,,60,0,60,58,0,58
4/2/2023 17:00,10,7,3,19,12,7,30,15,15,0,0,0,9,9,0,4,4,0,0,0,0,119,49,70,0,,74,0,74,70,0,70
4/2/2023 18:00,9,6,3,19,11,8,22,12,10,0,0,0,9,9,0,8,8,0,0,0,0,105,54,51,0,,85,1,84,73,0,73
4/2/2023 19:00,4,2,2,10,4,6,14,3,11,0,0,0,8,8,0,6,6,0,0,0,0,80,39,41,0,,72,0,72,82,1,81
4/2/2023 20:00,11,7,4,4,2,2,16,8,8,0,0,0,9,9,0,6,6,0,0,0,0,66,35,31,0,,58,0,58,75,0,75
4/2/2023 21:00,5,4,1,4,1,3,11,5,6,0,0,0,5,5,0,6,6,0,0,0,0,54,30,24,0,,42,0,42,74,0,74
4/2/2023 22:00,7,4,3,6,3,3,3,1,2,0,0,0,4,4,0,1,1,0,0,0,0,48,30,18,0,,26,0,26,34,0,34
4/2/2023 23:00,1,0,1,4,2,2,7,5,2,0,0,0,1,1,0,1,1,0,0,0,0,32,18,14,0,,21,1,20,14,0,14
5/2/2023 0:00,3,1,2,0,0,0,3,1,2,0,0,0,2,2,0,2,2,0,0,0,0,27,20,7,0,,15,0,15,9,0,9
5/2/2023 1:00,0,0,0,5,4,1,3,1,2,0,0,0,0,0,0,0,0,0,0,0,0,24,13,11,0,,6,0,6,2,0,2
5/2/2023 2:00,0,0,0,0,0,0,1,0,1,0,0,0,1,1,0,0,0,0,0,0,0,13,7,6,0,,15,0,15,6,0,6
5/2/2023 3:00,1,0,1,0,0,0,1,0,1,0,0,0,0,0,0,2,2,0,0,0,0,4,3,1,0,,7,0,7,6,0,6
5/2/2023 4:00,3,2,1,0,0,0,0,0,0,0,0,0,0,0,0,1,1,0,0,0,0,14,8,6,0,,12,1,11,4,0,4
5/2/2023 5:00,3,1,2,2,1,1,2,1,1,0,0,0,1,1,0,1,1,0,0,0,0,5,2,3,0,,7,0,7,2,0,2
5/2/2023 6:00,1,0,1,4,1,3,4,1,3,0,0,0,4,4,0,1,1,0,0,0,0,23,6,17,0,,2,0,2,4,0,4
5/2/2023 7:00,4,3,1,18,7,11,19,5,14,0,0,0,6,6,0,1,1,0,4,4,0,23,9,14,0,,6,0,6,5,0,5
5/2/2023 8:00,3,2,1,55,21,34,73,31,42,0,0,0,8,8,0,4,4,0,1,1,0,19,9,10,0,,11,0,11,8,0,8
5/2/2023 9:00,4,4,0,88,40,48,90,35,55,0,0,0,11,11,0,8,8,0,1,1,0,52,16,36,0,,12,0,12,36,0,36
5/2/2023 10:00,8,7,1,123,40,83,136,54,82,0,0,0,7,7,0,8,8,0,0,0,0,61,10,51,0,,23,0,23,47,1,46
5/2/2023 11:00,7,4,3,132,60,72,183,77,106,0,0,0,5,5,0,10,10,0,1,1,0,78,25,53,0,,29,0,29,60,0,60
5/2/2023 12:00,14,9,5,158,72,86,199,97,102,0,0,0,2,2,0,5,5,0,1,1,0,87,31,56,0,,45,1,44,62,1,61
5/2/2023 13:00,15,7,8,145,74,71,182,76,106,0,0,0,3,2,1,18,18,0,0,0,0,88,33,55,0,,44,0,44,96,1,95
5/2/2023 14:00,11,7,4,128,74,54,178,86,92,0,0,0,4,4,0,15,15,0,1,1,0,88,30,58,0,,50,1,49,74,1,73
5/2/2023 15:00,10,5,5,141,71,70,164,91,73,0,0,0,5,4,1,15,15,0,2,2,0,87,35,52,0,,47,0,47,69,0,69
5/2/2023 16:00,12,4,8,92,53,39,132,90,42,0,0,0,4,4,0,6,6,0,2,2,0,96,35,61,0,,53,0,53,66,0,66
5/2/2023 17:00,4,3,1,68,38,30,68,37,31,0,0,0,7,7,0,6,6,0,0,0,0,96,36,60,0,,71,0,71,76,0,76
5/2/2023 18:00,6,3,3,25,15,10,47,32,15,0,0,0,3,3,0,12,12,0,0,0,0,82,44,38,0,,68,0,68,81,1,80
5/2/2023 19:00,9,5,4,8,4,4,11,7,4,0,0,0,5,5,0,11,11,0,0,0,0,80,35,45,0,,60,0,60,68,1,67
5/2/2023 20:00,6,3,3,2,1,1,7,1,6,0,0,0,3,3,0,5,5,0,1,1,0,62,30,32,0,,57,0,57,59,1,58
5/2/2023 21:00,5,3,2,2,1,1,4,2,2,0,0,0,6,6,0,6,6,0,1,1,0,60,36,24,0,,49,0,49,45,1,44
5/2/2023 22:00,6,3,3,2,1,1,3,1,2,0,0,0,2,2,0,4,4,0,2,2,0,48,24,24,0,,31,0,31,34,0,34
5/2/2023 23:00,2,0,2,1,0,1,5,1,4,0,0,0,4,4,0,1,1,0,0,0,0,40,23,17,0,,35,1,34,26,0,26
6/2/2023 0:00,3,3,0,0,0,0,0,0,0,0,0,0,2,2,0,2,2,0,0,0,0,20,12,8,0,,18,0,18,13,0,13
6/2/2023 1:00,0,0,0,2,2,0,2,2,0,0,0,0,0,0,0,0,0,0,0,0,0,11,9,2,0,,5,0,5,3,0,3
6/2/2023 2:00,1,0,1,0,0,0,0,0,0,0,0,0,3,3,0,0,0,0,0,0,0,8,5,3,0,,11,0,11,7,0,7
6/2/2023 3:00,0,0,0,0,0,0,0,0,0,0,0,0,1,1,0,2,2,0,0,0,0,7,4,3,0,,6,0,6,3,0,3
6/2/2023 4:00,1,0,1,0,0,0,0,0,0,0,0,0,0,0,0,0,0,0,0,0,0,8,4,4,0,,5,0,5,2,0,2
6/2/2023 5:00,0,0,0,2,1,1,3,1,2,0,0,0,1,1,0,1,1,0,0,0,0,7,4,3,0,,6,0,6,2,0,2
6/2/2023 6:00,3,2,1,0,0,0,0,0,0,0,0,0,2,2,0,1,1,0,0,0,0,38,9,29,0,,4,0,4,15,0,15
6/2/2023 7:00,2,2,0,15,8,7,21,10,11,0,0,0,13,13,0,1,1,0,0,0,0,33,5,28,0,,8,0,8,7,0,7
6/2/2023 8:00,5,2,3,47,20,27,49,23,26,0,0,0,7,7,0,3,3,0,0,0,0,51,8,43,0,,5,0,5,17,1,16
6/2/2023 9:00,3,2,1,88,36,52,88,33,55,0,0,0,6,6,0,3,3,0,0,0,0,53,11,42,0,,18,1,17,29,0,29
6/2/2023 10:00,6,5,1,165,58,107,190,68,122,0,0,0,5,5,0,17,17,0,0,0,0,64,20,44,0,,23,0,23,42,0,42
6/2/2023 11:00,17,12,5,152,81,71,189,88,101,0,0,0,4,4,0,12,12,0,3,3,0,66,26,40,0,,46,0,46,45,0,45
6/2/2023 12:00,7,2,5,162,86,76,179,101,78,0,0,0,0,0,0,18,18,0,6,6,0,77,37,40,0,,38,0,38,45,2,43
6/2/2023 13:00,12,7,5,132,68,64,158,75,83,0,0,0,1,1,0,23,23,0,8,8,0,85,35,50,0,,66,1,65,77,0,77
6/2/2023 14:00,9,6,3,111,59,52,122,68,54,0,0,0,4,4,0,14,14,0,1,1,0,86,33,53,0,,53,0,53,68,1,67
6/2/2023 15:00,14,9,5,107,53,54,139,72,67,0,0,0,4,4,0,13,13,0,0,0,0,78,32,46,0,,56,1,55,85,0,85
6/2/2023 16:00,6,5,1,105,64,41,110,66,44,0,0,0,3,3,0,8,8,0,0,0,0,107,55,52,0,,72,0,72,59,0,59
6/2/2023 17:00,11,3,8,44,25,19,78,40,38,0,0,0,6,6,0,11,11,0,0,0,0,101,49,52,0,,67,0,67,71,0,71
6/2/2023 18:00,6,3,3,35,23,12,32,16,16,0,0,0,4,4,0,6,6,0,0,0,0,105,62,43,0,,87,0,87,69,0,69
6/2/2023 19:00,11,1,10,12,5,7,18,7,11,0,0,0,1,1,0,14,14,0,1,1,0,90,50,40,0,,66,0,66,71,0,71
6/2/2023 20:00,7,3,4,11,8,3,20,8,12,0,0,0,1,1,0,4,4,0,0,0,0,70,42,28,0,,71,0,71,67,0,67
6/2/2023 21:00,5,3,2,6,3,3,8,3,5,0,0,0,1,1,0,7,7,0,0,0,0,52,26,26,0,,37,0,37,47,1,46
6/2/2023 22:00,6,5,1,3,3,0,4,1,3,0,0,0,3,3,0,2,2,0,0,0,0,33,21,12,0,,20,0,20,24,0,24
6/2/2023 23:00,1,0,1,1,1,0,2,1,1,0,0,0,0,0,0,0,0,0,0,0,0,19,11,8,0,,17,0,17,21,0,21
7/2/2023 0:00,1,0,1,0,0,0,1,1,0,0,0,0,1,1,0,0,0,0,1,1,0,10,7,3,0,,12,0,12,6,0,6
7/2/2023 1:00,1,0,1,2,2,0,2,2,0,0,0,0,0,0,0,0,0,0,0,0,0,4,3,1,0,,1,0,1,0,0,0
7/2/2023 2:00,0,0,0,1,0,1,6,3,3,0,0,0,1,1,0,0,0,0,0,0,0,3,3,0,0,,7,0,7,4,0,4
7/2/2023 3:00,1,1,0,1,1,0,1,0,1,0,0,0,0,0,0,0,0,0,1,1,0,5,2,3,0,,2,0,2,0,0,0
7/2/2023 4:00,0,0,0,1,0,1,1,0,1,0,0,0,0,0,0,0,0,0,1,1,0,7,1,6,0,,1,0,1,2,0,2
7/2/2023 5:00,2,1,1,8,5,3,6,3,3,0,0,0,0,0,0,0,0,0,0,0,0,28,5,23,0,,4,0,4,8,0,8
7/2/2023 6:00,10,10,0,23,20,3,27,23,4,0,0,0,14,14,0,12,12,0,3,3,0,129,28,101,0,,11,0,11,25,0,25
7/2/2023 7:00,45,38,7,68,59,9,77,66,11,0,0,0,32,32,0,19,19,0,13,13,0,315,61,254,0,,29,0,29,79,0,79
7/2/2023 8:00,117,103,14,82,68,14,107,86,21,0,0,0,58,58,0,43,43,0,34,34,0,627,105,522,0,,41,0,41,213,1,212
7/2/2023 9:00,54,48,6,38,24,14,57,40,17,0,0,0,31,31,0,18,18,0,12,12,0,264,43,221,0,,46,1,45,144,1,143
7/2/2023 10:00,16,10,6,51,24,27,56,24,32,0,0,0,5,5,0,7,7,0,2,2,0,86,22,64,0,,26,1,25,68,0,68
7/2/2023 11:00,14,11,3,52,27,25,58,28,30,0,0,0,3,3,0,11,11,0,2,2,0,97,36,61,0,,36,0,36,62,1,61
7/2/2023 12:00,19,14,5,48,26,22,62,29,33,0,0,0,3,3,0,10,10,0,0,0,0,96,35,61,0,,60,0,60,93,1,92
7/2/2023 13:00,17,6,11,44,20,24,52,21,31,0,0,0,3,3,0,17,17,0,0,0,0,122,62,60,0,,80,0,80,77,0,77
7/2/2023 14:00,19,10,9,42,16,26,49,13,36,0,0,0,3,3,0,17,17,0,0,0,0,110,52,58,0,,56,0,56,67,0,67
7/2/2023 15:00,23,7,16,45,22,23,47,16,31,0,0,0,5,5,0,35,35,0,3,3,0,148,80,68,0,,80,1,79,47,0,47
7/2/2023 16:00,36,14,22,64,25,39,69,19,50,0,0,0,6,6,0,33,33,0,2,2,0,232,148,84,0,,143,0,143,73,0,73
7/2/2023 17:00,79,16,63,89,17,72,136,27,109,0,0,0,6,6,0,40,40,0,7,7,0,440,318,122,0,,226,0,226,111,0,111
7/2/2023 18:00,48,19,29,81,14,67,98,14,84,0,0,0,0,0,0,34,34,0,19,19,0,328,230,98,0,,220,0,220,113,0,113
7/2/2023 19:00,16,8,8,50,15,35,65,18,47,0,0,0,2,1,1,25,25,0,17,17,0,227,152,75,0,,144,0,144,93,0,93
7/2/2023 20:00,11,0,11,12,2,10,22,6,16,0,0,0,1,1,0,16,16,0,8,8,0,126,67,59,0,,102,1,101,86,2,84
7/2/2023 21:00,9,1,8,12,4,8,25,10,15,0,0,0,4,4,0,11,11,0,1,1,0,80,58,22,0,,73,0,73,45,1,44
7/2/2023 22:00,5,1,4,4,1,3,9,1,8,0,0,0,3,3,0,1,1,0,1,1,0,62,39,23,0,,48,0,48,36,0,36
7/2/2023 23:00,3,2,1,1,1,0,1,0,1,0,0,0,0,0,0,1,1,0,0,0,0,32,22,10,0,,16,0,16,20,0,20
8/2/2023 0:00,2,0,2,0,0,0,3,0,3,0,0,0,0,0,0,0,0,0,0,0,0,11,6,5,0,,11,0,11,8,0,8
8/2/2023 1:00,1,0,1,2,1,1,1,1,0,0,0,0,0,0,0,0,0,0,0,0,0,6,5,1,0,,1,0,1,1,0,1
8/2/2023 2:00,1,1,0,0,0,0,0,0,0,0,0,0,0,0,0,0,0,0,0,0,0,1,0,1,0,,4,0,4,1,0,1
8/2/2023 3:00,0,0,0,1,1,0,2,1,1,0,0,0,1,1,0,0,0,0,1,1,0,1,0,1,0,,3,0,3,1,0,1
8/2/2023 4:00,2,2,0,0,0,0,0,0,0,0,0,0,2,2,0,0,0,0,0,0,0,13,3,10,0,,2,0,2,3,0,3
8/2/2023 5:00,3,3,0,4,4,0,5,3,2,0,0,0,0,0,0,1,1,0,0,0,0,25,4,21,0,,3,0,3,10,0,10
8/2/2023 6:00,14,13,1,20,16,4,32,24,8,0,0,0,12,12,0,4,4,0,1,1,0,131,30,101,0,,8,0,8,30,1,29
8/2/2023 7:00,37,34,3,71,58,13,79,66,13,0,0,0,29,29,0,17,17,0,1,1,0,321,56,265,0,,38,0,38,96,0,96
8/2/2023 8:00,133,114,19,90,69,21,133,111,22,0,0,0,67,66,1,44,44,0,33,33,0,716,116,600,0,,41,1,40,267,1,266
8/2/2023 9:00,51,44,7,40,24,16,64,42,22,0,0,0,38,38,0,11,11,0,13,13,0,287,51,236,0,,28,0,28,162,3,159
8/2/2023 10:00,20,12,8,52,26,26,54,25,29,0,0,0,7,7,0,9,9,0,6,6,0,95,30,65,0,,37,0,37,77,1,76
8/2/2023 11:00,16,11,5,45,22,23,56,29,27,0,0,0,8,8,0,13,13,0,4,4,0,80,16,64,0,,37,0,37,71,0,71
8/2/2023 12:00,24,16,8,62,28,34,72,27,45,0,0,0,4,4,0,11,11,0,0,0,0,104,40,64,0,,65,0,65,73,0,73
8/2/2023 13:00,29,16,13,44,24,20,51,21,30,0,0,0,4,4,0,26,26,0,4,4,0,112,59,53,0,,61,0,61,100,0,100
8/2/2023 14:00,13,7,6,44,15,29,44,16,28,0,0,0,3,2,1,12,12,0,5,5,0,130,60,70,0,,56,0,56,59,0,59
8/2/2023 15:00,23,12,11,24,9,15,38,15,23,0,0,0,9,9,0,26,26,0,10,10,0,145,81,64,0,,67,0,67,63,0,63
8/2/2023 16:00,39,16,23,50,15,35,72,17,55,0,0,0,4,4,0,35,35,0,8,8,0,264,164,100,0,,111,0,111,69,1,68
8/2/2023 17:00,68,12,56,66,13,53,100,21,79,0,0,0,1,1,0,41,41,0,4,4,0,444,305,139,0,,218,1,217,101,1,100
8/2/2023 18:00,44,19,25,95,20,75,119,16,103,0,0,0,2,2,0,36,36,0,2,2,0,377,265,112,0,,202,0,202,109,0,109
8/2/2023 19:00,11,3,8,49,7,42,69,14,55,0,0,0,5,5,0,16,16,0,0,0,0,175,110,65,0,,116,0,116,92,1,91
8/2/2023 20:00,16,5,11,10,2,8,16,3,13,0,0,0,6,6,0,10,10,0,0,0,0,129,84,45,0,,81,0,81,62,1,61
8/2/2023 21:00,5,2,3,15,11,4,19,8,11,0,0,0,14,14,0,9,9,0,0,0,0,80,48,32,0,,57,0,57,51,0,51
8/2/2023 22:00,10,5,5,11,4,7,14,2,12,0,0,0,6,6,0,6,6,0,1,1,0,48,33,15,0,,36,0,36,41,0,41
8/2/2023 23:00,5,3,2,2,0,2,7,2,5,0,0,0,2,2,0,4,4,0,2,2,0,30,24,6,0,,34,0,34,19,0,19
9/2/2023 0:00,0,0,0,3,1,2,5,1,4,0,0,0,1,1,0,2,2,0,1,1,0,13,11,2,0,,13,0,13,8,0,8
9/2/2023 1:00,6,3,3,1,1,0,3,2,1,0,0,0,0,0,0,0,0,0,0,0,0,6,5,1,0,,2,0,2,1,0,1
9/2/2023 2:00,0,0,0,0,0,0,0,0,0,0,0,0,0,0,0,0,0,0,0,0,0,2,2,0,0,,3,0,3,3,0,3
9/2/2023 3:00,0,0,0,1,1,0,1,1,0,0,0,0,0,0,0,0,0,0,0,0,0,4,1,3,0,,6,0,6,1,0,1
9/2/2023 4:00,0,0,0,0,0,0,0,0,0,0,0,0,2,2,0,0,0,0,1,1,0,7,0,7,0,,3,0,3,1,0,1
9/2/2023 5:00,7,5,2,7,5,2,4,3,1,0,0,0,1,1,0,1,1,0,0,0,0,22,2,20,0,,2,0,2,8,0,8
9/2/2023 6:00,13,12,1,13,11,2,16,14,2,0,0,0,3,3,0,8,8,0,1,1,0,122,20,102,0,,9,0,9,29,0,29
9/2/2023 7:00,42,38,4,59,46,13,70,59,11,0,0,0,22,22,0,14,14,0,10,10,0,298,66,232,0,,32,0,32,83,0,83
9/2/2023 8:00,121,100,21,83,67,16,120,107,13,0,0,0,79,79,0,54,54,0,62,62,0,644,105,539,0,,56,0,56,198,2,196
9/2/2023 9:00,49,42,7,45,28,17,54,39,15,0,0,0,38,38,0,16,16,0,6,6,0,264,40,224,0,,41,3,38,153,1,152
9/2/2023 10:00,16,12,4,44,20,24,43,19,24,0,0,0,16,16,0,10,10,0,0,0,0,95,26,69,0,,32,0,32,58,0,58
9/2/2023 11:00,17,10,7,51,29,22,49,26,23,0,0,0,17,17,0,10,10,0,0,0,0,76,15,61,0,,45,0,45,73,1,72
9/2/2023 12:00,29,17,12,44,19,25,58,24,34,0,0,0,3,3,0,13,13,0,0,0,0,105,45,60,0,,60,1,59,90,1,89
9/2/2023 13:00,14,7,7,46,19,27,71,27,44,0,0,0,8,8,0,13,13,0,0,0,0,115,53,62,0,,72,1,71,99,0,99
9/2/2023 14:00,16,11,5,59,24,35,72,32,40,0,0,0,8,7,1,19,19,0,0,0,0,125,64,61,0,,83,0,83,58,0,58
9/2/2023 15:00,15,8,7,55,24,31,50,22,28,0,0,0,5,5,0,39,39,0,3,3,0,148,79,69,0,,100,0,100,54,2,52
9/2/2023 16:00,37,13,24,48,18,30,70,23,47,0,0,0,6,6,0,36,36,0,8,8,0,218,137,81,0,,114,0,114,64,0,64
9/2/2023 17:00,44,18,26,82,20,62,124,26,98,0,0,0,14,13,1,35,35,0,9,9,0,403,278,125,0,,221,0,221,92,1,91
9/2/2023 18:00,46,13,33,91,27,64,117,27,90,0,0,0,5,5,0,37,37,0,9,9,0,344,226,118,0,,222,1,221,100,0,100
9/2/2023 19:00,14,8,6,44,15,29,64,18,46,0,0,0,3,3,0,19,19,0,14,14,0,221,130,91,0,,121,0,121,104,0,104
9/2/2023 20:00,23,8,15,24,8,16,38,9,29,0,0,0,2,2,0,18,18,0,3,3,0,152,88,64,0,,100,0,100,101,0,101
9/2/2023 21:00,18,7,11,10,7,3,16,5,11,0,0,0,2,2,0,14,14,0,0,0,0,87,62,25,0,,81,0,81,56,0,56
9/2/2023 22:00,5,4,1,9,3,6,10,2,8,0,0,0,4,4,0,5,5,0,0,0,0,57,33,24,0,,60,0,60,30,0,30
9/2/2023 23:00,3,2,1,1,0,1,5,1,4,0,0,0,3,3,0,1,1,0,2,2,0,41,34,7,0,,49,0,49,21,0,21
10/2/2023 0:00,1,0,1,3,1,2,5,2,3,0,0,0,2,2,0,3,3,0,0,0,0,17,12,5,0,,26,0,26,8,0,8
10/2/2023 1:00,0,0,0,1,1,0,1,1,0,0,0,0,0,0,0,1,1,0,0,0,0,7,5,2,0,,3,0,3,1,0,1
10/2/2023 2:00,0,0,0,1,0,1,2,0,2,0,0,0,0,0,0,1,1,0,0,0,0,6,3,3,0,,4,0,4,3,0,3
10/2/2023 3:00,1,1,0,1,1,0,0,0,0,0,0,0,0,0,0,0,0,0,0,0,0,6,3,3,0,,6,0,6,0,0,0
10/2/2023 4:00,1,0,1,0,0,0,1,0,1,0,0,0,0,0,0,0,0,0,2,2,0,11,4,7,0,,3,0,3,1,0,1
10/2/2023 5:00,2,2,0,12,7,5,9,3,6,0,0,0,1,1,0,0,0,0,1,1,0,27,4,23,0,,3,0,3,12,0,12
10/2/2023 6:00,7,7,0,12,10,2,14,12,2,0,0,0,2,2,0,11,11,0,0,0,0,107,21,86,0,,12,0,12,26,0,26
10/2/2023 7:00,28,24,4,41,30,11,41,32,9,0,0,0,39,39,0,15,15,0,1,1,0,210,63,147,0,,24,1,23,66,0,66
10/2/2023 8:00,72,64,8,64,49,15,81,58,23,0,0,0,39,39,0,39,39,0,3,3,0,397,78,319,0,,35,1,34,162,0,162
10/2/2023 9:00,34,25,9,43,28,15,54,32,22,0,0,0,26,26,0,9,9,0,5,5,0,215,44,171,0,,22,0,22,142,1,141
10/2/2023 10:00,8,7,1,37,15,22,46,17,29,0,0,0,23,23,0,4,4,0,6,6,0,99,30,69,0,,26,0,26,80,2,78
10/2/2023 11:00,16,9,7,42,16,26,51,22,29,0,0,0,6,6,0,12,12,0,12,12,0,82,25,57,0,,33,1,32,59,0,59
10/2/2023 12:00,17,7,10,48,24,24,43,24,19,0,0,0,7,7,0,17,17,0,12,12,0,148,59,89,0,,83,0,83,74,1,73
10/2/2023 13:00,20,6,14,51,24,27,53,24,29,0,0,0,3,3,0,23,23,0,15,15,0,140,69,71,0,,102,0,102,100,0,100
10/2/2023 14:00,18,9,9,36,11,25,43,18,25,0,0,0,4,4,0,20,20,0,12,12,0,125,62,63,0,,78,1,77,82,0,82
10/2/2023 15:00,19,9,10,45,22,23,54,23,31,0,0,0,7,7,0,21,21,0,5,5,0,153,81,72,0,,87,0,87,79,0,79
10/2/2023 16:00,30,7,23,62,31,31,70,29,41,0,0,0,3,3,0,30,30,0,2,2,0,239,141,98,0,,113,0,113,105,1,104
10/2/2023 17:00,48,8,40,61,19,42,83,22,61,0,0,0,3,3,0,25,25,0,0,0,0,271,159,112,0,,168,0,168,130,0,130
10/2/2023 18:00,16,7,9,62,13,49,75,14,61,0,0,0,3,3,0,25,25,0,0,0,0,231,120,111,0,,141,0,141,125,0,125
10/2/2023 19:00,15,8,7,23,7,16,37,13,24,0,0,0,6,6,0,11,11,0,0,0,0,154,82,72,0,,94,0,94,105,0,105
10/2/2023 20:00,9,4,5,15,8,7,16,7,9,0,0,0,8,8,0,12,12,0,0,0,0,129,75,54,0,,80,0,80,81,0,81
10/2/2023 21:00,9,6,3,7,3,4,11,4,7,0,0,0,1,1,0,9,9,0,2,2,0,86,49,37,0,,58,0,58,70,2,68
10/2/2023 22:00,5,2,3,5,3,2,13,5,8,0,0,0,3,3,0,3,3,0,0,0,0,59,34,25,0,,52,0,52,60,0,60
10/2/2023 23:00,5,3,2,5,2,3,8,4,4,0,0,0,3,3,0,1,1,0,0,0,0,41,28,13,0,,30,0,30,42,0,42
11/2/2023 0:00,2,1,1,1,1,0,5,2,3,0,0,0,0,0,0,5,5,0,1,1,0,29,20,9,0,,31,0,31,23,0,23
11/2/2023 1:00,2,1,1,5,2,3,3,2,1,0,0,0,1,1,0,0,0,0,0,0,0,13,10,3,0,,9,1,8,3,0,3
11/2/2023 2:00,0,0,0,1,0,1,2,0,2,0,0,0,0,0,0,0,0,0,0,0,0,19,14,5,0,,8,0,8,3,0,3
11/2/2023 3:00,0,0,0,0,0,0,0,0,0,0,0,0,0,0,0,1,1,0,0,0,0,6,4,2,0,,10,0,10,3,0,3
11/2/2023 4:00,0,0,0,0,0,0,2,0,2,0,0,0,0,0,0,0,0,0,0,0,0,8,7,1,0,,9,0,9,0,0,0
11/2/2023 5:00,0,0,0,0,0,0,0,0,0,0,0,0,0,0,0,0,0,0,0,0,0,5,1,4,0,,3,0,3,6,0,6
11/2/2023 6:00,3,3,0,12,7,5,10,6,4,0,0,0,4,4,0,1,1,0,1,1,0,42,10,32,0,,4,0,4,7,0,7
11/2/2023 7:00,6,6,0,20,5,15,21,4,17,0,0,0,8,8,0,2,2,0,4,4,0,26,13,13,0,,8,0,8,9,0,9
11/2/2023 8:00,6,5,1,51,22,29,40,17,23,0,0,0,14,12,2,9,9,0,7,7,0,72,17,55,0,,15,0,15,26,0,26
11/2/2023 9:00,12,9,3,102,34,68,120,44,76,0,0,0,12,12,0,13,13,0,8,8,0,100,34,66,0,,23,0,23,60,0,60
11/2/2023 10:00,15,7,8,102,47,55,112,53,59,0,0,0,8,8,0,17,17,0,9,9,0,104,32,72,0,,48,0,48,83,0,83
11/2/2023 11:00,20,15,5,132,57,75,133,61,72,0,0,0,0,0,0,12,12,0,14,14,0,132,59,73,0,,48,0,48,76,1,75
11/2/2023 12:00,17,11,6,127,71,56,119,63,56,0,0,0,1,1,0,13,13,0,19,19,0,138,31,107,0,,54,0,54,89,0,89
11/2/2023 13:00,15,13,2,101,54,47,119,60,59,0,0,0,2,1,1,14,14,0,11,11,0,162,54,108,0,,93,0,93,111,0,111
11/2/2023 14:00,10,6,4,81,42,39,93,43,50,0,0,0,6,6,0,11,11,0,7,7,0,114,52,62,0,,81,1,80,88,1,87
11/2/2023 15:00,8,5,3,64,28,36,84,39,45,0,0,0,13,13,0,8,8,0,4,4,0,80,38,42,0,,75,0,75,74,0,74
11/2/2023 16:00,14,5,9,63,34,29,94,56,38,0,0,0,11,11,0,10,10,0,6,6,0,118,62,56,0,,52,0,52,83,0,83
11/2/2023 17:00,19,7,12,41,24,17,50,28,22,0,0,0,6,5,1,12,12,0,5,5,0,142,55,87,0,,99,0,99,85,0,85
11/2/2023 18:00,4,3,1,19,10,9,36,18,18,0,0,0,6,6,0,12,12,0,3,3,0,144,59,85,0,,81,0,81,109,0,109
11/2/2023 19:00,10,6,4,16,5,11,23,8,15,0,0,0,2,2,0,10,10,0,3,3,0,88,38,50,0,,48,0,48,93,0,93
11/2/2023 20:00,5,2,3,11,6,5,14,7,7,0,0,0,6,6,0,10,10,0,0,0,0,83,46,37,0,,37,0,37,90,0,90
11/2/2023 21:00,9,3,6,4,2,2,10,2,8,0,0,0,7,7,0,4,4,0,0,0,0,62,31,31,0,,50,0,50,79,0,79
11/2/2023 22:00,2,1,1,6,2,4,7,2,5,0,0,0,4,4,0,1,1,0,0,0,0,53,38,15,0,,28,0,28,31,0,31
11/2/2023 23:00,1,1,0,2,0,2,3,0,3,0,0,0,4,3,1,5,5,0,0,0,0,48,33,15,0,,33,0,33,32,0,32
12/2/2023 0:00,0,0,0,4,3,1,6,4,2,0,0,0,0,0,0,1,1,0,0,0,0,27,20,7,0,,18,0,18,12,0,12
12/2/2023 1:00,0,0,0,2,2,0,4,3,1,0,0,0,0,0,0,2,2,0,0,0,0,23,17,6,0,,9,0,9,1,0,1
12/2/2023 2:00,2,1,1,3,1,2,2,1,1,0,0,0,0,0,0,0,0,0,0,0,0,9,4,5,0,,14,0,14,11,1,10
12/2/2023 3:00,1,1,0,1,0,1,2,0,2,0,0,0,0,0,0,0,0,0,0,0,0,8,5,3,0,,13,0,13,5,0,5
12/2/2023 4:00,0,0,0,1,0,1,2,0,2,0,0,0,2,2,0,3,3,0,0,0,0,10,6,4,0,,9,1,8,6,0,6
12/2/2023 5:00,0,0,0,3,1,2,5,0,5,0,0,0,1,1,0,0,0,0,0,0,0,6,5,1,0,,5,0,5,4,0,4
12/2/2023 6:00,1,1,0,8,3,5,7,2,5,0,0,0,1,1,0,1,1,0,0,0,0,22,4,18,0,,3,0,3,3,0,3
12/2/2023 7:00,0,0,0,19,6,13,19,6,13,0,0,0,4,4,0,2,2,0,1,1,0,28,6,22,0,,2,0,2,7,0,7
12/2/2023 8:00,3,3,0,63,25,38,66,32,34,0,0,0,5,5,0,3,3,0,10,10,0,29,9,20,0,,11,0,11,13,0,13
12/2/2023 9:00,11,9,2,148,47,101,153,52,101,0,0,0,7,7,0,25,25,0,7,7,0,69,30,39,0,,17,0,17,36,0,36
12/2/2023 10:00,6,3,3,139,56,83,177,65,112,0,0,0,7,7,0,14,14,0,9,9,0,82,29,53,0,,25,0,25,49,0,49
12/2/2023 11:00,11,8,3,166,97,69,190,90,100,0,0,0,5,5,0,12,12,0,11,11,0,109,41,68,0,,31,0,31,45,0,45
12/2/2023 12:00,13,6,7,145,82,63,186,90,96,0,0,0,7,7,0,17,17,0,0,0,0,101,31,70,0,,45,0,45,97,1,96
12/2/2023 13:00,21,15,6,126,56,70,168,73,95,0,0,0,6,6,0,21,21,0,9,9,0,100,33,67,0,,54,0,54,108,0,108
12/2/2023 14:00,18,9,9,142,75,67,181,93,88,0,0,0,6,6,0,27,27,0,16,16,0,109,47,62,0,,60,0,60,87,1,86
12/2/2023 15:00,16,9,7,96,50,46,149,77,72,0,0,0,4,4,0,11,11,0,11,11,0,94,39,55,0,,63,0,63,83,0,83
12/2/2023 16:00,12,7,5,82,51,31,107,64,43,0,0,0,2,2,0,13,13,0,3,3,0,84,55,29,0,,69,0,69,71,1,70
12/2/2023 17:00,7,5,2,36,25,11,50,30,20,0,0,0,2,2,0,12,12,0,0,0,0,104,44,60,0,,85,0,85,76,0,76
12/2/2023 18:00,10,5,5,18,9,9,26,15,11,0,0,0,4,4,0,8,8,0,0,0,0,109,59,50,0,,87,0,87,87,0,87
12/2/2023 19:00,5,3,2,9,2,7,15,4,11,0,0,0,3,3,0,5,5,0,0,0,0,81,45,36,0,,80,0,80,81,0,81
12/2/2023 20:00,7,5,2,6,3,3,14,5,9,0,0,0,2,2,0,8,8,0,0,0,0,67,33,34,0,,61,1,60,74,0,74
12/2/2023 21:00,14,9,5,8,2,6,14,6,8,0,0,0,1,1,0,8,8,0,0,0,0,42,21,21,0,,39,0,39,53,0,53
12/2/2023 22:00,2,2,0,3,1,2,4,3,1,0,0,0,0,0,0,1,1,0,0,0,0,35,20,15,0,,31,0,31,34,0,34
12/2/2023 23:00,2,1,1,2,2,0,4,1,3,0,0,0,2,2,0,3,3,0,1,1,0,26,17,9,0,,19,0,19,20,0,20
13/02/2023 00:00,2,1,1,0,0,0,1,1,0,0,0,0,0,0,0,1,1,0,1,1,0,20,14,6,0,,15,0,15,5,1,4
13/02/2023 01:00,0,0,0,1,1,0,0,0,0,0,0,0,0,0,0,1,1,0,0,0,0,3,2,1,0,,3,0,3,1,0,1
13/02/2023 02:00,2,0,2,0,0,0,1,1,0,0,0,0,0,0,0,0,0,0,0,0,0,6,3,3,0,,2,0,2,4,0,4
13/02/2023 03:00,0,0,0,2,2,0,2,2,0,0,0,0,0,0,0,1,1,0,0,0,0,7,4,3,0,,4,1,3,0,0,0
13/02/2023 04:00,2,1,1,0,0,0,0,0,0,0,0,0,0,0,0,0,0,0,0,0,0,6,2,4,0,,1,0,1,4,0,4
13/02/2023 05:00,3,3,0,5,3,2,8,4,4,0,0,0,1,1,0,0,0,0,0,0,0,33,6,27,0,,3,0,3,10,0,10
13/02/2023 06:00,9,8,1,19,13,6,21,15,6,0,0,0,11,11,0,8,8,0,0,0,0,111,20,91,0,,8,1,7,29,1,28
13/02/2023 07:00,37,35,2,47,41,6,55,45,10,0,0,0,19,19,0,17,17,0,0,0,0,250,59,191,0,,22,0,22,86,1,85
13/02/2023 08:00,81,73,8,75,60,15,98,79,19,0,0,0,35,35,0,36,36,0,0,0,0,487,78,409,0,,45,1,44,191,1,190
13/02/2023 09:00,31,25,6,33,16,17,51,34,17,0,0,0,23,23,0,7,7,0,0,0,0,194,23,171,0,,41,0,41,129,0,129
13/02/2023 10:00,8,6,2,40,17,23,49,18,31,0,0,0,10,10,0,5,5,0,0,0,0,82,24,58,0,,23,0,23,74,0,74
13/02/2023 11:00,10,8,2,36,16,20,43,20,23,0,0,0,3,3,0,8,8,0,0,0,0,79,28,51,0,,45,0,45,60,0,60
13/02/2023 12:00,24,12,12,57,30,27,65,31,34,0,0,0,5,5,0,11,11,0,3,3,0,86,27,59,0,,62,2,60,79,0,79
13/02/2023 13:00,15,8,7,50,22,28,57,27,30,0,0,0,4,4,0,15,15,0,9,9,0,112,43,69,0,,80,0,80,115,1,114
13/02/2023 14:00,15,5,10,49,23,26,68,26,42,0,0,0,3,3,0,11,11,0,3,3,0,91,46,45,0,,82,0,82,75,0,75
13/02/2023 15:00,14,7,7,52,24,28,70,30,40,0,0,0,1,1,0,15,15,0,0,0,0,140,77,63,0,,86,1,85,63,0,63
13/02/2023 16:00,28,16,12,83,28,55,85,35,50,0,0,0,3,2,1,23,23,0,0,0,0,211,135,76,0,,147,1,146,71,0,71
13/02/2023 17:00,48,17,31,70,16,54,96,12,84,0,0,0,4,4,0,38,38,0,0,0,0,350,229,121,0,,234,2,232,102,0,102
13/02/2023 18:00,43,11,32,54,10,44,82,19,63,0,0,0,3,3,0,33,33,0,0,0,0,294,197,97,0,,208,0,208,119,1,118
13/02/2023 19:00,19,7,12,32,11,21,43,15,28,0,0,0,3,3,0,17,17,0,0,0,0,144,104,40,0,,105,0,105,73,1,72
13/02/2023 20:00,9,3,6,13,4,9,19,7,12,0,0,0,4,4,0,9,9,0,0,0,0,109,63,46,0,,90,0,90,75,0,75
13/02/2023 21:00,8,5,3,7,2,5,12,2,10,0,0,0,4,4,0,13,13,0,0,0,0,75,43,32,0,,51,0,51,44,0,44
13/02/2023 22:00,6,3,3,4,2,2,5,1,4,0,0,0,4,4,0,9,9,0,0,0,0,52,33,19,0,,41,1,40,27,0,27
13/02/2023 23:00,1,1,0,3,0,3,4,1,3,0,0,0,1,1,0,0,0,0,3,3,0,19,11,8,0,,28,0,28,13,0,13
14/02/2023 00:00,2,1,1,1,0,1,3,1,2,0,0,0,2,2,0,0,0,0,0,0,0,11,10,1,0,,12,0,12,7,0,7
14/02/2023 01:00,0,0,0,2,2,0,0,0,0,0,0,0,0,0,0,0,0,0,0,0,0,4,4,0,0,,0,0,0,2,0,2
14/02/2023 02:00,1,1,0,0,0,0,0,0,0,0,0,0,0,0,0,0,0,0,0,0,0,5,2,3,0,,6,0,6,3,0,3
14/02/2023 03:00,0,0,0,1,1,0,1,0,1,0,0,0,1,1,0,0,0,0,0,0,0,5,3,2,0,,6,0,6,1,0,1
14/02/2023 04:00,0,0,0,1,1,0,2,1,1,0,0,0,1,1,0,0,0,0,0,0,0,11,3,8,0,,2,0,2,0,0,0
14/02/2023 05:00,3,3,0,2,1,1,6,2,4,0,0,0,0,0,0,0,0,0,1,1,0,32,4,28,0,,2,0,2,12,0,12
14/02/2023 06:00,11,10,1,15,11,4,18,12,6,0,0,0,6,6,0,9,9,0,7,7,0,120,29,91,0,,11,0,11,36,0,36
14/02/2023 07:00,43,38,5,71,59,12,86,73,13,0,0,0,29,29,0,20,20,0,10,10,0,316,62,254,0,,29,0,29,100,0,100
14/02/2023 08:00,125,115,10,75,60,15,114,97,17,0,0,0,49,49,0,26,26,0,21,21,0,616,90,526,0,,46,1,45,190,0,190
14/02/2023 09:00,22,19,3,39,26,13,42,24,18,0,0,0,23,23,0,14,14,0,10,10,0,252,42,210,0,,46,0,46,163,1,162
14/02/2023 10:00,3,3,0,61,25,36,66,28,38,0,0,0,16,16,0,7,7,0,4,4,0,97,33,64,0,,41,1,40,57,1,56
14/02/2023 11:00,12,8,4,29,15,14,37,19,18,0,0,0,12,12,0,9,9,0,7,7,0,75,25,50,0,,47,0,47,59,1,58
14/02/2023 12:00,10,5,5,50,28,22,41,18,23,0,0,0,3,3,0,9,9,0,11,11,0,88,35,53,0,,55,0,55,82,0,82
14/02/2023 13:00,10,5,5,40,17,23,68,31,37,0,0,0,3,3,0,13,13,0,5,5,0,115,53,62,0,,84,1,83,86,0,86
14/02/2023 14:00,9,2,7,43,16,27,37,12,25,0,0,0,3,3,0,9,9,0,5,5,0,104,51,53,0,,73,0,73,65,0,65
14/02/2023 15:00,14,5,9,49,16,33,52,17,35,0,0,0,6,6,0,15,15,0,8,8,0,121,58,63,0,,71,0,71,55,0,55
14/02/2023 16:00,22,9,13,57,22,35,62,21,41,0,0,0,6,6,0,27,27,0,11,11,0,242,151,91,0,,142,1,141,97,0,97
14/02/2023 17:00,52,10,42,86,19,67,144,36,108,0,0,0,3,3,0,32,32,0,8,8,0,421,293,128,0,,270,2,268,122,0,122
14/02/2023 18:00,40,15,25,66,14,52,97,22,75,0,0,0,5,5,0,33,33,0,0,0,0,378,249,129,0,,201,0,201,111,0,111
14/02/2023 19:00,11,3,8,24,8,16,46,17,29,0,0,0,1,1,0,26,26,0,0,0,0,206,132,74,0,,124,0,124,80,0,80
14/02/2023 20:00,8,3,5,18,7,11,23,9,14,0,0,0,3,3,0,9,9,0,1,1,0,119,63,56,0,,89,2,87,76,0,76
14/02/2023 21:00,6,2,4,10,2,8,18,6,12,0,0,0,2,2,0,6,6,0,1,1,0,79,50,29,0,,60,0,60,63,0,63
14/02/2023 22:00,7,2,5,2,1,1,11,2,9,0,0,0,4,4,0,6,6,0,0,0,0,49,32,17,0,,49,0,49,46,0,46
14/02/2023 23:00,1,1,0,3,0,3,4,0,4,0,0,0,3,3,0,1,1,0,1,1,0,33,24,9,0,,36,1,35,16,0,16
15/02/2023 00:00,0,0,0,2,2,0,5,0,5,0,0,0,1,1,0,0,0,0,2,2,0,24,22,2,0,,28,0,28,7,0,7
15/02/2023 01:00,1,1,0,2,2,0,0,0,0,0,0,0,0,0,0,0,0,0,1,1,0,2,2,0,0,,3,0,3,0,0,0
15/02/2023 02:00,0,0,0,1,0,1,0,0,0,0,0,0,0,0,0,0,0,0,0,0,0,4,1,3,0,,4,0,4,1,0,1
15/02/2023 03:00,0,0,0,1,1,0,0,0,0,0,0,0,0,0,0,1,1,0,0,0,0,5,2,3,0,,4,0,4,2,0,2
15/02/2023 04:00,0,0,0,0,0,0,3,1,2,0,0,0,0,0,0,0,0,0,0,0,0,11,4,7,0,,1,0,1,1,0,1
15/02/2023 05:00,4,3,1,1,1,0,4,2,2,0,0,0,0,0,0,0,0,0,0,0,0,20,4,16,0,,2,0,2,12,0,12
15/02/2023 06:00,4,3,1,13,8,5,15,11,4,0,0,0,11,11,0,7,7,0,0,0,0,91,16,75,0,,6,0,6,21,0,21
15/02/2023 07:00,10,9,1,48,45,3,56,49,7,0,0,0,20,20,0,8,8,0,5,5,0,275,64,211,0,,21,0,21,65,1,64
15/02/2023 08:00,28,22,6,48,43,5,73,65,8,0,0,0,60,59,1,23,23,0,10,10,0,583,94,489,0,,50,0,50,219,0,219
15/02/2023 09:00,12,5,7,40,26,14,41,28,13,0,0,0,18,18,0,15,15,0,6,6,0,253,40,213,0,,29,1,28,160,0,160
15/02/2023 10:00,11,9,2,34,18,16,36,12,24,0,0,0,11,11,0,9,9,0,0,0,0,78,17,61,0,,28,0,28,69,1,68
15/02/2023 11:00,9,6,3,45,23,22,48,21,27,0,0,0,5,5,0,9,9,0,7,7,0,73,30,43,0,,52,0,52,70,3,67
15/02/2023 12:00,6,4,2,46,22,24,48,20,28,0,0,0,3,3,0,11,11,0,11,11,0,99,38,61,0,,68,0,68,93,0,93
15/02/2023 13:00,15,10,5,44,25,19,41,23,18,0,0,0,6,6,0,11,11,0,8,8,0,107,50,57,0,,72,0,72,96,0,96
15/02/2023 14:00,6,2,4,31,16,15,49,23,26,0,0,0,3,3,0,15,15,0,6,6,0,89,33,56,0,,72,2,70,73,1,72
15/02/2023 15:00,11,7,4,34,13,21,43,12,31,0,0,0,9,9,0,15,15,0,5,5,0,123,67,56,0,,80,1,79,69,0,69
15/02/2023 16:00,20,9,11,51,26,25,59,27,32,0,0,0,6,6,0,16,16,0,8,8,0,200,126,74,0,,108,0,108,60,0,60
15/02/2023 17:00,31,6,25,74,18,56,111,32,79,0,0,0,3,2,1,32,32,0,0,0,0,391,268,123,0,,218,2,216,89,0,89
15/02/2023 18:00,17,4,13,65,13,52,98,21,77,0,0,0,13,13,0,31,31,0,0,0,0,334,215,119,0,,191,1,190,106,1,105
15/02/2023 19:00,19,7,12,54,13,41,66,17,49,0,0,0,6,6,0,13,13,0,0,0,0,208,124,84,0,,127,1,126,84,0,84
15/02/2023 20:00,6,4,2,15,7,8,25,10,15,0,0,0,2,2,0,17,17,0,1,1,0,118,78,40,0,,95,0,95,73,0,73
15/02/2023 21:00,4,1,3,9,4,5,15,8,7,0,0,0,1,1,0,11,11,0,0,0,0,86,56,30,0,,68,1,67,48,0,48
15/02/2023 22:00,8,5,3,5,0,5,8,3,5,0,0,0,1,1,0,8,8,0,0,0,0,58,41,17,0,,51,0,51,37,0,37
15/02/2023 23:00,2,1,1,2,1,1,1,0,1,0,0,0,1,1,0,1,1,0,0,0,0,30,19,11,0,,17,0,17,17,0,17
16/02/2023 00:00,0,0,0,0,0,0,1,0,1,0,0,0,0,0,0,1,1,0,0,0,0,12,12,0,0,,16,0,16,8,0,8
16/02/2023 01:00,0,0,0,1,1,0,1,1,0,0,0,0,0,0,0,2,2,0,0,0,0,9,8,1,0,,3,0,3,1,0,1
16/02/2023 02:00,1,0,1,0,0,0,0,0,0,0,0,0,0,0,0,0,0,0,0,0,0,4,3,1,0,,1,0,1,3,1,2
16/02/2023 03:00,1,0,1,1,1,0,2,1,1,0,0,0,0,0,0,0,0,0,0,0,0,6,2,4,0,,2,0,2,0,0,0
16/02/2023 04:00,0,0,0,0,0,0,3,0,3,0,0,0,2,2,0,1,1,0,0,0,0,9,4,5,0,,1,0,1,0,0,0
16/02/2023 05:00,5,5,0,5,3,2,4,3,1,0,0,0,2,2,0,0,0,0,0,0,0,30,5,25,0,,2,0,2,9,0,9
16/02/2023 06:00,9,7,2,18,14,4,18,14,4,0,0,0,13,13,0,11,11,0,0,0,0,96,25,71,0,,7,0,7,20,0,20
16/02/2023 07:00,16,11,5,56,48,8,53,46,7,0,0,0,21,21,0,14,14,0,0,0,0,277,61,216,0,,23,0,23,75,0,75
16/02/2023 08:00,39,29,10,77,57,20,108,88,20,0,0,0,79,79,0,16,16,0,0,0,0,538,79,459,0,,50,1,49,228,0,228
16/02/2023 09:00,16,9,7,32,22,10,41,32,9,0,0,0,44,44,0,19,19,0,0,0,0,221,31,190,0,,38,1,37,144,0,144
16/02/2023 10:00,2,1,1,36,14,22,52,21,31,0,0,0,10,10,0,9,9,0,0,0,0,87,22,65,0,,33,0,33,63,0,63
16/02/2023 11:00,6,4,2,27,13,14,34,21,13,0,0,0,10,10,0,7,7,0,0,0,0,88,35,53,0,,42,0,42,83,0,83
16/02/2023 12:00,6,3,3,30,13,17,47,18,29,0,0,0,5,5,0,6,6,0,2,2,0,89,31,58,0,,61,0,61,90,0,90
16/02/2023 13:00,10,7,3,40,21,19,43,23,20,0,0,0,8,8,0,11,11,0,2,2,0,115,40,75,0,,84,0,84,95,0,95
16/02/2023 14:00,13,8,5,29,10,19,37,19,18,0,0,0,7,7,0,13,13,0,0,0,0,98,52,46,0,,74,1,73,68,0,68
16/02/2023 15:00,16,8,8,47,23,24,55,23,32,0,0,0,4,4,0,15,15,0,0,0,0,120,64,56,0,,69,0,69,69,1,68
16/02/2023 16:00,24,6,18,69,33,36,81,29,52,0,0,0,4,4,0,19,19,0,0,0,0,198,123,75,0,,102,1,101,73,0,73
16/02/2023 17:00,34,9,25,70,16,54,129,30,99,0,0,0,6,6,0,32,32,0,0,0,0,387,268,119,0,,210,0,210,105,1,104
16/02/2023 18:00,23,7,16,105,38,67,117,33,84,0,0,0,1,1,0,28,28,0,0,0,0,327,214,113,0,,193,0,193,117,2,115
16/02/2023 19:00,15,4,11,38,13,25,48,15,33,0,0,0,6,6,0,17,17,0,0,0,0,195,115,80,0,,126,0,126,85,0,85
16/02/2023 20:00,8,4,4,27,10,17,37,14,23,0,0,0,2,2,0,10,10,0,0,0,0,137,84,53,0,,67,0,67,104,0,104
16/02/2023 21:00,11,3,8,5,3,2,13,5,8,0,0,0,1,1,0,13,13,0,0,0,0,75,49,26,0,,51,0,51,62,0,62
16/02/2023 22:00,4,0,4,9,3,6,18,3,15,0,0,0,1,1,0,4,4,0,0,0,0,81,57,24,0,,34,0,34,42,1,41
16/02/2023 23:00,4,3,1,5,3,2,11,3,8,0,0,0,5,5,0,3,3,0,0,0,0,44,30,14,0,,36,0,36,27,0,27
17/02/2023 00:00,0,0,0,1,0,1,7,5,2,0,0,0,2,2,0,1,1,0,0,0,0,21,16,5,0,,22,0,22,13,0,13
17/02/2023 01:00,0,0,0,1,1,0,1,0,1,0,0,0,1,1,0,0,0,0,0,0,0,3,2,1,0,,1,0,1,0,0,0
17/02/2023 02:00,0,0,0,0,0,0,0,0,0,0,0,0,0,0,0,0,0,0,0,0,0,11,7,4,0,,2,0,2,2,0,2
17/02/2023 03:00,0,0,0,1,1,0,1,1,0,0,0,0,0,0,0,0,0,0,0,0,0,10,7,3,0,,6,0,6,1,0,1
17/02/2023 04:00,1,0,1,2,0,2,3,0,3,0,0,0,1,1,0,1,1,0,0,0,0,8,4,4,0,,3,0,3,3,0,3
17/02/2023 05:00,7,5,2,3,1,2,2,1,1,0,0,0,2,2,0,0,0,0,0,0,0,22,2,20,0,,2,0,2,9,1,8
17/02/2023 06:00,5,5,0,13,10,3,15,10,5,0,0,0,10,10,0,7,7,0,0,0,0,82,17,65,0,,7,0,7,21,0,21
17/02/2023 07:00,11,5,6,17,14,3,33,27,6,0,0,0,20,19,1,9,9,0,0,0,0,154,43,111,0,,23,0,23,48,0,48
17/02/2023 08:00,25,20,5,24,20,4,38,33,5,0,0,0,36,35,1,20,20,0,0,0,0,318,53,265,0,,35,0,35,112,0,112
17/02/2023 09:00,16,10,6,27,16,11,38,19,19,0,0,0,25,24,1,9,9,0,0,0,0,157,26,131,0,,32,0,32,107,0,107
17/02/2023 10:00,6,2,4,33,15,18,58,28,30,0,0,0,17,17,0,7,7,0,5,5,0,78,26,52,0,,34,0,34,64,1,63
17/02/2023 11:00,6,4,2,42,20,22,45,23,22,0,0,0,5,5,0,13,13,0,8,8,0,97,30,67,0,,42,0,42,78,0,78
17/02/2023 12:00,6,4,2,28,14,14,26,12,14,0,0,0,10,10,0,11,11,0,5,5,0,102,37,65,0,,73,0,73,82,0,82
17/02/2023 13:00,12,5,7,32,16,16,36,15,21,0,0,0,5,5,0,8,8,0,2,2,0,103,43,60,0,,78,1,77,111,0,111
17/02/2023 14:00,17,8,9,37,18,19,61,26,35,0,0,0,10,10,0,11,11,0,0,0,0,106,42,64,0,,59,0,59,62,0,62
17/02/2023 15:00,16,5,11,43,17,26,65,27,38,0,0,0,9,9,0,13,13,0,0,0,0,127,70,57,0,,67,0,67,66,0,66
17/02/2023 16:00,27,10,17,44,18,26,62,27,35,0,0,0,5,5,0,16,16,0,0,0,0,163,95,68,0,,115,0,115,59,1,58
17/02/2023 17:00,28,5,23,42,14,28,74,26,48,0,0,0,4,4,0,20,20,0,0,0,0,267,159,108,0,,140,0,140,125,0,125
17/02/2023 18:00,13,7,6,32,10,22,41,8,33,0,0,0,2,2,0,25,25,0,0,0,0,214,111,103,0,,95,1,94,104,0,104
17/02/2023 19:00,13,4,9,19,3,16,28,9,19,0,0,0,9,9,0,12,12,0,0,0,0,189,105,84,0,,105,0,105,90,1,89
17/02/2023 20:00,9,4,5,14,5,9,23,11,12,0,0,0,8,8,0,6,6,0,0,0,0,102,52,50,0,,82,0,82,110,0,110
17/02/2023 21:00,11,5,6,4,2,2,7,3,4,0,0,0,7,7,0,4,4,0,0,0,0,83,50,33,0,,70,1,69,93,0,93
17/02/2023 22:00,6,5,1,3,1,2,7,1,6,0,0,0,5,5,0,4,4,0,1,1,0,55,38,17,0,,40,0,40,50,1,49
17/02/2023 23:00,3,1,2,2,1,1,6,1,5,0,0,0,1,1,0,1,1,0,0,0,0,41,25,16,0,,30,1,29,27,0,27
18/02/2023 00:00,0,0,0,0,0,0,1,0,1,0,0,0,1,1,0,2,2,0,0,0,0,35,28,7,0,,35,0,35,19,1,18
18/02/2023 01:00,2,1,1,1,1,0,2,1,1,0,0,0,2,2,0,1,1,0,0,0,0,21,12,9,0,,11,0,11,1,1,0
18/02/2023 02:00,0,0,0,1,0,1,1,0,1,0,0,0,0,0,0,0,0,0,0,0,0,9,7,2,0,,17,0,17,5,0,5
18/02/2023 03:00,0,0,0,0,0,0,0,0,0,0,0,0,0,0,0,0,0,0,0,0,0,9,5,4,0,,8,0,8,5,0,5
18/02/2023 04:00,2,0,2,0,0,0,1,0,1,0,0,0,0,0,0,0,0,0,0,0,0,12,9,3,0,,9,0,9,2,0,2
18/02/2023 05:00,0,0,0,0,0,0,0,0,0,0,0,0,1,1,0,1,1,0,0,0,0,11,4,7,0,,4,0,4,7,0,7
18/02/2023 06:00,2,1,1,3,3,0,2,2,0,0,0,0,6,6,0,1,1,0,0,0,0,27,6,21,0,,2,0,2,8,0,8
18/02/2023 07:00,2,2,0,12,5,7,17,4,13,0,0,0,14,14,0,4,4,0,1,1,0,39,15,24,0,,12,0,12,9,0,9
18/02/2023 08:00,4,0,4,55,24,31,57,24,33,0,0,0,11,11,0,7,7,0,4,4,0,43,18,25,0,,11,0,11,33,0,33
18/02/2023 09:00,10,5,5,82,36,46,89,37,52,0,0,0,5,5,0,6,6,0,4,4,0,80,30,50,0,,21,1,20,49,2,47
18/02/2023 10:00,7,3,4,63,24,39,83,33,50,0,0,0,4,4,0,17,17,0,3,3,0,91,33,58,0,,34,1,33,64,1,63
18/02/2023 11:00,17,6,11,75,39,36,102,47,55,0,0,0,3,3,0,5,5,0,3,3,0,92,36,56,0,,55,0,55,64,0,64
18/02/2023 12:00,6,4,2,65,34,31,80,43,37,0,0,0,2,2,0,15,15,0,1,1,0,99,33,66,0,,69,0,69,111,2,109
18/02/2023 13:00,9,7,2,65,38,27,90,48,42,0,0,0,7,7,0,9,9,0,2,2,0,102,36,66,0,,55,0,55,126,0,126
18/02/2023 14:00,11,5,6,68,32,36,62,27,35,0,0,0,8,8,0,13,13,0,2,2,0,107,44,63,0,,69,0,69,97,0,97
18/02/2023 15:00,2,1,1,31,14,17,49,21,28,0,0,0,9,9,0,16,16,0,1,1,0,101,37,64,0,,82,0,82,96,0,96
18/02/2023 16:00,8,3,5,38,22,16,59,35,24,0,0,0,12,12,0,13,13,0,1,1,0,118,51,67,0,,90,1,89,81,3,78
18/02/2023 17:00,10,8,2,41,18,23,53,23,30,0,0,0,14,14,0,7,7,0,0,0,0,97,40,57,0,,90,0,90,86,0,86
18/02/2023 18:00,5,1,4,17,9,8,18,11,7,0,0,0,14,13,1,15,15,0,1,1,0,109,52,57,0,,77,0,77,74,1,73
18/02/2023 19:00,6,3,3,9,5,4,15,6,9,0,0,0,8,8,0,7,7,0,2,2,0,109,47,62,0,,73,1,72,124,1,123
18/02/2023 20:00,7,4,3,10,6,4,17,10,7,0,0,0,7,7,0,4,4,0,0,0,0,70,29,41,0,,63,0,63,92,0,92
18/02/2023 21:00,7,4,3,4,3,1,6,3,3,0,0,0,2,2,0,3,3,0,1,1,0,70,29,41,0,,40,2,38,81,1,80
18/02/2023 22:00,1,0,1,2,2,0,2,1,1,0,0,0,2,2,0,1,1,0,0,0,0,76,37,39,0,,30,0,30,54,0,54
18/02/2023 23:00,9,2,7,2,1,1,3,1,2,0,0,0,2,2,0,2,2,0,0,0,0,34,25,9,0,,30,0,30,29,0,29
19/02/2023 00:00,2,1,1,1,1,0,4,2,2,0,0,0,0,0,0,2,2,0,0,0,0,30,19,11,0,,23,0,23,20,0,20
19/02/2023 01:00,2,2,0,3,3,0,5,3,2,0,0,0,3,3,0,1,1,0,0,0,0,14,12,2,0,,5,0,5,2,0,2
19/02/2023 02:00,0,0,0,0,0,0,1,0,1,0,0,0,1,1,0,1,1,0,0,0,0,7,5,2,0,,12,0,12,8,1,7
19/02/2023 03:00,0,0,0,2,2,0,0,0,0,0,0,0,0,0,0,0,0,0,0,0,0,17,8,9,0,,13,0,13,4,0,4
19/02/2023 04:00,1,1,0,1,1,0,4,2,2,0,0,0,2,2,0,0,0,0,0,0,0,13,10,3,0,,6,0,6,4,1,3
19/02/2023 05:00,1,0,1,3,2,1,4,2,2,0,0,0,0,0,0,1,1,0,0,0,0,9,3,6,0,,4,0,4,3,0,3
19/02/2023 06:00,1,1,0,2,1,1,3,1,2,0,0,0,2,2,0,0,0,0,0,0,0,24,6,18,0,,3,0,3,9,0,9
19/02/2023 07:00,1,1,0,22,5,17,19,5,14,0,0,0,9,9,0,3,3,0,0,0,0,32,11,21,0,,3,0,3,6,1,5
19/02/2023 08:00,3,0,3,69,31,38,75,29,46,0,0,0,9,9,0,8,8,0,0,0,0,42,18,24,0,,8,0,8,13,0,13
19/02/2023 09:00,8,4,4,120,53,67,126,54,72,0,0,0,7,7,0,13,13,0,0,0,0,85,38,47,0,,8,1,7,33,0,33
19/02/2023 10:00,2,1,1,123,49,74,152,53,99,0,0,0,6,6,0,13,13,0,2,2,0,80,21,59,0,,18,0,18,43,0,43
19/02/2023 11:00,8,6,2,126,64,62,139,62,77,0,0,0,3,3,0,18,18,0,3,3,0,101,38,63,0,,37,0,37,42,1,41
19/02/2023 12:00,7,2,5,114,59,55,122,66,56,0,0,0,6,6,0,12,12,0,2,2,0,103,40,63,0,,50,0,50,89,3,86
19/02/2023 13:00,13,8,5,106,58,48,116,51,65,0,0,0,6,6,0,22,22,0,8,8,0,106,38,68,0,,54,0,54,81,0,81
19/02/2023 14:00,11,5,6,87,40,47,111,47,64,0,0,0,5,5,0,15,15,0,1,1,0,133,56,77,0,,49,0,49,84,2,82
19/02/2023 15:00,13,5,8,105,50,55,130,57,73,0,0,0,9,9,0,11,11,0,2,2,0,80,27,53,0,,53,1,52,73,0,73
19/02/2023 16:00,12,3,9,81,46,35,87,51,36,0,0,0,6,6,0,13,13,0,5,5,0,89,46,43,0,,58,1,57,60,0,60
19/02/2023 17:00,9,5,4,48,28,20,67,41,26,0,0,0,4,4,0,13,13,0,4,4,0,115,52,63,0,,68,1,67,51,0,51
19/02/2023 18:00,6,1,5,30,15,15,32,16,16,0,0,0,7,7,0,11,11,0,1,1,0,137,47,90,0,,60,1,59,76,1,75
19/02/2023 19:00,7,4,3,19,10,9,19,7,12,0,0,0,6,6,0,15,15,0,3,3,0,97,50,47,0,,55,0,55,80,0,80
19/02/2023 20:00,6,2,4,10,3,7,18,8,10,0,0,0,4,4,0,4,4,0,1,1,0,59,33,26,0,,35,0,35,79,0,79
19/02/2023 21:00,3,1,2,5,2,3,9,4,5,0,0,0,2,2,0,0,0,0,1,1,0,49,25,24,0,,50,0,50,43,0,43
19/02/2023 22:00,2,1,1,2,1,1,6,2,4,0,0,0,3,3,0,4,4,0,2,2,0,41,28,13,0,,26,0,26,23,0,23
19/02/2023 23:00,1,0,1,1,1,0,4,1,3,0,0,0,3,3,0,1,1,0,0,0,0,21,15,6,0,,31,0,31,15,0,15
20/02/2023 00:00,0,0,0,1,0,1,2,2,0,0,0,0,2,1,1,2,2,0,1,1,0,10,8,2,0,,7,0,7,4,0,4
20/02/2023 01:00,0,0,0,1,1,0,1,1,0,0,0,0,0,0,0,0,0,0,0,0,0,3,3,0,0,,0,0,0,0,0,0
20/02/2023 02:00,0,0,0,0,0,0,0,0,0,0,0,0,0,0,0,0,0,0,0,0,0,4,2,2,0,,0,0,0,1,0,1
20/02/2023 03:00,0,0,0,1,1,0,1,0,1,0,0,0,0,0,0,0,0,0,0,0,0,5,2,3,0,,2,0,2,2,0,2
20/02/2023 04:00,0,0,0,1,1,0,1,1,0,0,0,0,0,0,0,0,0,0,1,1,0,10,2,8,0,,0,0,0,3,1,2
20/02/2023 05:00,2,2,0,5,2,3,5,2,3,0,0,0,3,3,0,3,3,0,0,0,0,28,2,26,0,,3,0,3,6,0,6
20/02/2023 06:00,8,8,0,14,11,3,17,12,5,0,0,0,13,13,0,8,8,0,7,7,0,112,22,90,0,,9,0,9,15,0,15
20/02/2023 07:00,16,12,4,48,44,4,51,44,7,0,0,0,31,31,0,12,12,0,24,24,0,275,53,222,0,,29,0,29,82,0,82
20/02/2023 08:00,40,28,12,63,50,13,72,57,15,0,0,0,66,66,0,55,55,0,116,116,0,536,100,436,0,,43,0,43,184,1,183
20/02/2023 09:00,17,11,6,35,19,16,48,27,21,0,0,0,26,25,1,15,15,0,16,16,0,228,40,188,0,,49,0,49,124,1,123
20/02/2023 10:00,15,13,2,36,12,24,50,18,32,0,0,0,13,13,0,8,8,0,1,1,0,75,31,44,0,,23,0,23,54,0,54
20/02/2023 11:00,5,4,1,35,16,19,38,17,21,0,0,0,4,4,0,10,10,0,7,7,0,94,34,60,0,,35,1,34,67,0,67
20/02/2023 12:00,8,7,1,43,19,24,50,25,25,0,0,0,6,6,0,7,7,0,11,11,0,93,38,55,0,,59,0,59,78,0,78
20/02/2023 13:00,13,3,10,35,14,21,36,12,24,0,0,0,3,3,0,17,17,0,12,12,0,130,54,76,0,,70,0,70,84,1,83
20/02/2023 14:00,11,4,7,28,10,18,44,16,28,0,0,0,3,3,0,19,19,0,12,12,0,118,55,63,0,,65,0,65,62,0,62
20/02/2023 15:00,20,7,13,31,11,20,43,17,26,0,0,0,2,2,0,47,47,0,7,7,0,143,84,59,0,,68,0,68,44,1,43
20/02/2023 16:00,31,10,21,48,16,32,65,16,49,0,0,0,2,2,0,39,39,0,3,3,0,232,139,93,0,,126,0,126,60,0,60
20/02/2023 17:00,40,7,33,89,23,66,128,28,100,0,0,0,1,1,0,44,44,0,8,8,0,415,278,137,0,,206,0,206,118,0,118
20/02/2023 18:00,18,6,12,77,18,59,98,23,75,0,0,0,6,6,0,32,32,0,4,4,0,314,216,98,0,,219,0,219,116,0,116
20/02/2023 19:00,7,1,6,33,10,23,54,11,43,0,0,0,5,4,1,8,8,0,3,3,0,169,109,60,0,,134,0,134,71,0,71
20/02/2023 20:00,6,3,3,17,7,10,29,9,20,0,0,0,2,2,0,16,16,0,2,2,0,76,29,47,0,,94,1,93,88,0,88
20/02/2023 21:00,7,3,4,14,6,8,15,6,9,0,0,0,4,4,0,8,8,0,0,0,0,82,45,37,0,,62,0,62,52,0,52
20/02/2023 22:00,3,0,3,6,4,2,10,3,7,0,0,0,2,2,0,3,3,0,0,0,0,47,33,14,0,,29,0,29,24,0,24
20/02/2023 23:00,3,1,2,3,2,1,3,1,2,0,0,0,1,1,0,2,2,0,0,0,0,11,8,3,0,,27,0,27,13,0,13
21/02/2023 00:00,1,1,0,2,1,1,5,3,2,0,0,0,1,1,0,3,3,0,0,0,0,13,8,5,0,,11,0,11,4,0,4
21/02/2023 01:00,1,0,1,4,3,1,0,0,0,0,0,0,2,2,0,0,0,0,0,0,0,5,4,1,0,,2,0,2,1,0,1
21/02/2023 02:00,0,0,0,0,0,0,0,0,0,0,0,0,0,0,0,0,0,0,0,0,0,2,1,1,0,,2,0,2,1,0,1
21/02/2023 03:00,0,0,0,0,0,0,0,0,0,0,0,0,0,0,0,0,0,0,0,0,0,5,3,2,0,,5,0,5,2,0,2
21/02/2023 04:00,0,0,0,1,1,0,1,1,0,0,0,0,1,1,0,0,0,0,0,0,0,10,3,7,0,,2,0,2,2,0,2
21/02/2023 05:00,3,3,0,4,3,1,4,3,1,0,0,0,2,1,1,1,1,0,0,0,0,25,1,24,0,,1,0,1,7,0,7
21/02/2023 06:00,5,4,1,27,19,8,28,21,7,0,0,0,21,21,0,9,9,0,0,0,0,119,28,91,0,,11,0,11,30,0,30
21/02/2023 07:00,19,15,4,89,77,12,100,87,13,0,0,0,54,54,0,6,6,0,2,2,0,371,65,306,0,,33,0,33,93,0,93
21/02/2023 08:00,49,39,10,115,89,26,139,112,27,0,0,0,70,70,0,64,64,0,24,24,0,740,108,632,0,,57,1,56,220,0,220
21/02/2023 09:00,19,13,6,59,32,27,84,50,34,0,0,0,48,48,0,14,14,0,0,0,0,258,36,222,0,,38,1,37,170,0,170
21/02/2023 10:00,11,6,5,65,34,31,81,36,45,0,0,0,17,17,0,6,6,0,1,1,0,98,27,71,0,,34,1,33,84,0,84
21/02/2023 11:00,11,3,8,75,35,40,84,41,43,0,0,0,7,7,0,12,12,0,0,0,0,74,22,52,0,,38,0,38,59,0,59
21/02/2023 12:00,8,4,4,62,28,34,89,30,59,0,0,0,4,4,0,10,10,0,4,4,0,112,45,67,0,,69,0,69,85,0,85
21/02/2023 13:00,12,4,8,78,40,38,93,41,52,0,0,0,9,9,0,20,20,0,2,2,0,117,54,63,0,,72,0,72,63,0,63
21/02/2023 14:00,12,3,9,72,38,34,91,41,50,0,0,0,1,1,0,18,18,0,1,1,0,113,48,65,0,,74,1,73,68,0,68
21/02/2023 15:00,11,7,4,65,33,32,88,36,52,0,0,0,5,4,1,28,28,0,0,0,0,149,79,70,0,,80,0,80,63,0,63
21/02/2023 16:00,29,5,24,87,28,59,106,41,65,0,0,0,5,5,0,47,47,0,1,1,0,257,162,95,0,,134,0,134,87,0,87
21/02/2023 17:00,42,11,31,138,32,106,166,24,142,0,0,0,6,6,0,50,50,0,1,1,0,464,332,132,0,,281,2,279,83,1,82
21/02/2023 18:00,35,12,23,105,27,78,129,27,102,0,0,0,6,6,0,41,41,0,0,0,0,389,261,128,0,,248,1,247,108,0,108
21/02/2023 19:00,14,4,10,60,26,34,87,35,52,0,0,0,5,5,0,29,29,0,0,0,0,209,134,75,0,,132,0,132,130,0,130
21/02/2023 20:00,13,7,6,56,25,31,72,26,46,0,0,0,4,4,0,11,11,0,0,0,0,138,96,42,0,,97,0,97,101,0,101
21/02/2023 21:00,7,4,3,10,5,5,17,6,11,0,0,0,5,5,0,8,8,0,0,0,0,79,50,29,0,,63,0,63,45,1,44
21/02/2023 22:00,4,2,2,7,3,4,14,4,10,0,0,0,3,3,0,3,3,0,0,0,0,58,36,22,0,,42,0,42,24,0,24
21/02/2023 23:00,3,1,2,2,1,1,2,1,1,0,0,0,2,2,0,4,4,0,0,0,0,32,25,7,0,,26,0,26,14,0,14
22/02/2023 00:00,0,0,0,2,1,1,4,1,3,0,0,0,0,0,0,0,0,0,0,0,0,13,13,0,0,,16,0,16,6,0,6
22/02/2023 01:00,2,1,1,3,1,2,1,0,1,0,0,0,0,0,0,0,0,0,0,0,0,5,5,0,0,,0,0,0,0,0,0
22/02/2023 02:00,0,0,0,0,0,0,0,0,0,0,0,0,0,0,0,0,0,0,0,0,0,1,1,0,0,,3,0,3,1,0,1
22/02/2023 03:00,0,0,0,1,1,0,2,0,2,0,0,0,0,0,0,0,0,0,0,0,0,5,3,2,0,,4,0,4,1,0,1
22/02/2023 04:00,0,0,0,0,0,0,1,1,0,0,0,0,1,1,0,0,0,0,0,0,0,6,2,4,0,,2,0,2,1,0,1
22/02/2023 05:00,2,1,1,2,2,0,4,1,3,0,0,0,4,4,0,2,2,0,0,0,0,32,2,30,0,,4,0,4,11,0,11
22/02/2023 06:00,5,5,0,14,11,3,19,15,4,0,0,0,15,15,0,7,7,0,0,0,0,108,24,84,0,,6,0,6,30,0,30
22/02/2023 07:00,19,16,3,62,57,5,78,69,9,0,0,0,61,60,1,17,17,0,0,0,0,333,70,263,0,,40,0,40,97,2,95
22/02/2023 08:00,47,38,9,84,67,17,119,99,20,0,0,0,99,98,1,55,55,0,0,0,0,659,110,549,0,,48,0,48,228,1,227
22/02/2023 09:00,21,14,7,38,21,17,62,35,27,0,0,0,25,24,1,17,17,0,0,0,0,263,37,226,0,,43,1,42,154,1,153
22/02/2023 10:00,10,5,5,38,22,16,44,21,23,0,0,0,24,24,0,6,6,0,0,0,0,102,29,73,0,,32,0,32,77,0,77
22/02/2023 11:00,6,1,5,47,23,24,63,33,30,0,0,0,12,10,2,7,7,0,0,0,0,82,29,53,0,,45,3,42,80,0,80
22/02/2023 12:00,9,7,2,42,18,24,47,22,25,0,0,0,7,7,0,12,12,0,0,0,0,83,29,54,0,,75,1,74,59,2,57
22/02/2023 13:00,21,11,10,52,28,24,67,31,36,0,0,0,3,3,0,29,29,0,0,0,0,135,65,70,0,,66,1,65,82,0,82
22/02/2023 14:00,15,7,8,36,17,19,58,24,34,0,0,0,3,3,0,11,11,0,0,0,0,111,54,57,0,,74,1,73,63,1,62
22/02/2023 15:00,17,10,7,28,10,18,35,11,24,0,0,0,5,5,0,44,44,0,0,0,0,133,64,69,0,,93,0,93,63,0,63
22/02/2023 16:00,28,7,21,57,25,32,89,33,56,0,0,0,4,4,0,33,33,0,0,0,0,225,145,80,0,,123,0,123,65,2,63
22/02/2023 17:00,30,13,17,102,20,82,140,31,109,0,0,0,3,3,0,41,41,0,0,0,0,436,311,125,0,,239,2,237,116,1,115
22/02/2023 18:00,27,10,17,76,22,54,102,14,88,0,0,0,2,2,0,24,24,0,0,0,0,375,236,139,0,,215,1,214,101,0,101
22/02/2023 19:00,17,9,8,41,13,28,63,22,41,0,0,0,4,4,0,18,18,0,0,0,0,216,147,69,0,,117,0,117,89,0,89
22/02/2023 20:00,10,4,6,18,7,11,25,13,12,0,0,0,4,4,0,16,16,0,1,1,0,111,81,30,0,,101,1,100,86,0,86
22/02/2023 21:00,4,3,1,8,4,4,16,6,10,0,0,0,2,2,0,7,7,0,0,0,0,89,54,35,0,,70,0,70,46,0,46
22/02/2023 22:00,2,1,1,5,2,3,9,3,6,0,0,0,2,2,0,2,2,0,0,0,0,57,36,21,0,,44,0,44,39,0,39
22/02/2023 23:00,5,3,2,2,1,1,4,1,3,0,0,0,2,2,0,6,6,0,0,0,0,23,16,7,0,,23,0,23,16,0,16
23/02/2023 00:00,0,0,0,2,1,1,3,1,2,0,0,0,1,1,0,2,2,0,0,0,0,21,15,6,0,,15,0,15,8,0,8
23/02/2023 01:00,0,0,0,2,2,0,0,0,0,0,0,0,0,0,0,0,0,0,0,0,0,5,3,2,0,,0,0,0,0,0,0
23/02/2023 02:00,0,0,0,0,0,0,0,0,0,0,0,0,0,0,0,0,0,0,0,0,0,7,4,3,0,,6,0,6,0,0,0
23/02/2023 03:00,2,1,1,1,1,0,1,0,1,0,0,0,0,0,0,0,0,0,0,0,0,5,4,1,0,,4,0,4,1,0,1
23/02/2023 04:00,0,0,0,1,0,1,0,0,0,0,0,0,1,1,0,1,1,0,0,0,0,8,3,5,0,,2,0,2,1,0,1
23/02/2023 05:00,4,4,0,6,3,3,4,1,3,0,0,0,1,1,0,1,1,0,0,0,0,38,4,34,0,,4,0,4,5,0,5
23/02/2023 06:00,13,11,2,18,12,6,20,16,4,0,0,0,13,13,0,10,10,0,0,0,0,127,31,96,0,,8,0,8,19,0,19
23/02/2023 07:00,20,15,5,61,51,10,70,58,12,0,0,0,17,17,0,21,21,0,2,2,0,308,82,226,0,,36,0,36,90,0,90
23/02/2023 08:00,46,37,9,86,69,17,108,91,17,0,0,0,50,50,0,51,51,0,43,43,0,620,101,519,0,,42,0,42,192,0,192
23/02/2023 09:00,19,15,4,54,27,27,71,36,35,0,0,0,44,43,1,10,10,0,8,8,0,263,40,223,0,,20,1,19,147,1,146
23/02/2023 10:00,5,5,0,57,26,31,65,30,35,0,0,0,18,18,0,15,15,0,6,6,0,102,37,65,0,,24,0,24,75,0,75
23/02/2023 11:00,10,4,6,77,42,35,79,41,38,0,0,0,16,16,0,12,12,0,4,4,0,83,26,57,0,,36,0,36,80,0,80
23/02/2023 12:00,9,3,6,58,30,28,67,24,43,0,0,0,8,8,0,12,12,0,5,5,0,95,36,59,0,,67,0,67,84,0,84
23/02/2023 13:00,10,1,9,47,26,21,74,40,34,0,0,0,7,7,0,10,10,0,2,2,0,107,44,63,0,,77,1,76,87,0,87
23/02/2023 14:00,13,5,8,59,25,34,62,27,35,0,0,0,8,8,0,19,19,0,0,0,0,103,43,60,0,,56,0,56,73,0,73
23/02/2023 15:00,19,11,8,78,34,44,91,30,61,0,0,0,5,5,0,38,38,0,6,6,0,152,77,75,0,,78,1,77,84,0,84
23/02/2023 16:00,25,8,17,57,17,40,96,36,60,0,0,0,5,5,0,38,38,0,22,22,0,237,157,80,0,,138,0,138,96,0,96
23/02/2023 17:00,43,14,29,96,33,63,128,31,97,0,0,0,2,2,0,29,29,0,19,19,0,419,290,129,0,,210,2,208,81,0,81
23/02/2023 18:00,25,10,15,98,32,66,118,31,87,0,0,0,3,3,0,31,31,0,12,12,0,331,228,103,0,,228,1,227,111,0,111
23/02/2023 19:00,21,13,8,38,10,28,59,19,40,0,0,0,7,7,0,19,19,0,9,9,0,208,125,83,0,,130,1,129,103,0,103
23/02/2023 20:00,6,4,2,29,9,20,45,15,30,0,0,0,4,4,0,12,12,0,0,0,0,158,101,57,0,,102,0,102,127,0,127
23/02/2023 21:00,12,5,7,14,6,8,18,8,10,0,0,0,4,3,1,15,15,0,5,5,0,100,72,28,0,,83,1,82,64,0,64
23/02/2023 22:00,4,2,2,8,5,3,12,2,10,0,0,0,4,4,0,7,7,0,2,2,0,76,55,21,0,,51,0,51,21,0,21
23/02/2023 23:00,1,1,0,6,1,5,8,2,6,0,0,0,2,2,0,5,5,0,1,1,0,39,25,14,0,,47,0,47,17,0,17
24/02/2023 00:00,3,2,1,2,1,1,5,1,4,0,0,0,1,1,0,4,4,0,0,0,0,21,15,6,0,,34,0,34,6,0,6
24/02/2023 01:00,2,0,2,2,2,0,2,2,0,0,0,0,0,0,0,1,1,0,0,0,0,10,7,3,0,,2,0,2,1,0,1
24/02/2023 02:00,0,0,0,0,0,0,0,0,0,0,0,0,0,0,0,0,0,0,0,0,0,10,6,4,0,,7,1,6,1,0,1
24/02/2023 03:00,0,0,0,0,0,0,0,0,0,0,0,0,0,0,0,0,0,0,0,0,0,6,4,2,0,,3,0,3,4,0,4
24/02/2023 04:00,1,0,1,1,1,0,1,0,1,0,0,0,0,0,0,1,1,0,1,1,0,9,2,7,0,,2,0,2,0,0,0
24/02/2023 05:00,1,1,0,4,3,1,4,2,2,0,0,0,0,0,0,1,1,0,0,0,0,24,3,21,0,,3,0,3,10,0,10
24/02/2023 06:00,4,3,1,10,7,3,12,9,3,0,0,0,10,10,0,7,7,0,0,0,0,101,21,80,0,,6,0,6,19,0,19
24/02/2023 07:00,12,8,4,41,28,13,51,34,17,0,0,0,33,33,0,13,13,0,7,7,0,214,52,162,0,,34,1,33,67,1,66
24/02/2023 08:00,43,33,10,69,53,16,84,65,19,0,0,0,49,49,0,39,39,0,80,80,0,367,73,294,0,,41,0,41,123,0,123
24/02/2023 09:00,22,13,9,31,20,11,47,27,20,0,0,0,25,24,1,11,11,0,11,11,0,187,33,154,0,,28,0,28,107,2,105
24/02/2023 10:00,13,11,2,38,16,22,47,19,28,0,0,0,18,18,0,8,8,0,5,5,0,100,26,74,0,,34,0,34,70,0,70
24/02/2023 11:00,9,4,5,37,14,23,36,13,23,0,0,0,2,2,0,8,8,0,4,4,0,75,22,53,0,,42,1,41,67,0,67
24/02/2023 12:00,10,3,7,53,30,23,59,27,32,0,0,0,9,9,0,13,13,0,1,1,0,123,38,85,0,,88,0,88,94,1,93
24/02/2023 13:00,12,6,6,54,26,28,53,26,27,0,0,0,1,1,0,32,32,0,0,0,0,161,76,85,0,,90,0,90,109,0,109
24/02/2023 14:00,10,4,6,39,20,19,45,20,25,0,0,0,4,4,0,18,18,0,0,0,0,129,65,64,0,,97,0,97,88,1,87
24/02/2023 15:00,26,9,17,39,21,18,52,27,25,0,0,0,5,5,0,24,24,0,1,1,0,152,88,64,0,,75,0,75,75,0,75
24/02/2023 16:00,24,6,18,59,23,36,92,32,60,0,0,0,5,5,0,34,34,0,1,1,0,229,139,90,0,,124,0,124,95,1,94
24/02/2023 17:00,26,11,15,80,28,52,105,38,67,0,0,0,0,0,0,39,39,0,2,2,0,276,183,93,0,,143,1,142,122,1,121
24/02/2023 18:00,21,9,12,38,14,24,67,22,45,0,0,0,5,5,0,24,24,0,8,8,0,228,134,94,0,,192,1,191,102,0,102
24/02/2023 19:00,18,8,10,20,10,10,31,9,22,0,0,0,10,10,0,16,16,0,5,5,0,181,102,79,0,,119,1,118,110,0,110
24/02/2023 20:00,2,1,1,11,3,8,13,7,6,0,0,0,11,11,0,8,8,0,2,2,0,119,58,61,0,,78,2,76,97,0,97
24/02/2023 21:00,9,5,4,8,5,3,9,4,5,0,0,0,7,7,0,5,5,0,0,0,0,64,36,28,0,,56,0,56,88,0,88
24/02/2023 22:00,6,3,3,1,1,0,12,3,9,0,0,0,1,1,0,8,8,0,0,0,0,60,37,23,0,,36,0,36,49,1,48
24/02/2023 23:00,4,2,2,2,0,2,5,2,3,0,0,0,4,3,1,3,3,0,2,2,0,44,36,8,0,,33,0,33,32,0,32
25/02/2023 00:00,2,1,1,3,2,1,3,0,3,0,0,0,1,1,0,9,9,0,0,0,0,36,25,11,0,,23,1,22,9,1,8
25/02/2023 01:00,0,0,0,2,1,1,1,1,0,0,0,0,0,0,0,2,2,0,0,0,0,19,14,5,0,,5,0,5,3,0,3
25/02/2023 02:00,0,0,0,1,1,0,0,0,0,0,0,0,0,0,0,0,0,0,0,0,0,10,6,4,0,,14,0,14,5,0,5
25/02/2023 03:00,0,0,0,0,0,0,1,1,0,0,0,0,0,0,0,0,0,0,0,0,0,7,6,1,0,,15,0,15,3,0,3
25/02/2023 04:00,1,0,1,1,0,1,1,0,1,0,0,0,0,0,0,0,0,0,0,0,0,14,8,6,0,,10,0,10,4,0,4
25/02/2023 05:00,0,0,0,2,2,0,1,1,0,0,0,0,2,2,0,1,1,0,0,0,0,15,4,11,0,,5,0,5,2,0,2
25/02/2023 06:00,1,0,1,4,2,2,4,2,2,0,0,0,1,1,0,1,1,0,0,0,0,41,5,36,0,,8,0,8,8,0,8
25/02/2023 07:00,2,1,1,26,15,11,33,18,15,0,0,0,6,6,0,3,3,0,0,0,0,38,7,31,0,,6,0,6,7,0,7
25/02/2023 08:00,2,2,0,58,26,32,67,32,35,0,0,0,15,15,0,5,5,0,0,0,0,52,8,44,0,,13,0,13,35,0,35
25/02/2023 09:00,6,4,2,88,35,53,108,46,62,0,0,0,11,11,0,18,18,0,0,0,0,85,30,55,0,,25,0,25,57,0,57
25/02/2023 10:00,7,1,6,117,58,59,120,51,69,0,0,0,9,9,0,14,14,0,0,0,0,101,44,57,0,,35,2,33,87,0,87
25/02/2023 11:00,9,4,5,108,54,54,157,76,81,0,0,0,1,1,0,14,14,0,0,0,0,105,38,67,0,,52,0,52,79,2,77
25/02/2023 12:00,7,1,6,117,59,58,155,74,81,0,0,0,7,7,0,21,21,0,0,0,0,111,58,53,0,,69,0,69,99,0,99
25/02/2023 13:00,9,3,6,79,39,40,111,59,52,0,0,0,3,3,0,18,18,0,5,5,0,99,45,54,0,,69,0,69,108,0,108
25/02/2023 14:00,5,3,2,72,42,30,90,54,36,0,0,0,8,8,0,19,19,0,8,8,0,106,47,59,0,,85,0,85,86,1,85
25/02/2023 15:00,11,4,7,44,30,14,65,43,22,0,0,0,10,10,0,4,4,0,7,7,0,110,53,57,0,,69,0,69,78,3,75
25/02/2023 16:00,10,3,7,47,24,23,63,35,28,0,0,0,9,8,1,11,11,0,2,2,0,99,49,50,0,,70,0,70,64,1,63
25/02/2023 17:00,4,2,2,46,23,23,56,30,26,0,0,0,7,7,0,10,10,0,0,0,0,89,42,47,0,,75,0,75,80,0,80
25/02/2023 18:00,3,1,2,15,8,7,20,13,7,0,0,0,3,3,0,16,16,0,0,0,0,95,39,56,0,,89,1,88,76,0,76
25/02/2023 19:00,6,4,2,18,7,11,14,5,9,0,0,0,3,3,0,14,14,0,1,1,0,86,36,50,0,,70,0,70,95,0,95
25/02/2023 20:00,6,2,4,4,3,1,10,5,5,0,0,0,3,3,0,7,7,0,0,0,0,84,37,47,0,,68,0,68,53,0,53
25/02/2023 21:00,6,5,1,3,2,1,11,4,7,0,0,0,2,2,0,3,3,0,4,4,0,61,29,32,0,,44,1,43,57,0,57
25/02/2023 22:00,4,3,1,3,2,1,9,3,6,0,0,0,2,2,0,4,4,0,1,1,0,57,31,26,0,,22,0,22,36,0,36
25/02/2023 23:00,3,3,0,4,3,1,3,0,3,0,0,0,2,2,0,3,3,0,0,0,0,50,37,13,0,,20,0,20,22,1,21
26/02/2023 00:00,1,1,0,3,2,1,6,3,3,0,0,0,1,1,0,0,0,0,2,2,0,27,19,8,0,,22,0,22,12,0,12
26/02/2023 01:00,1,1,0,3,3,0,3,3,0,0,0,0,0,0,0,0,0,0,0,0,0,11,6,5,0,,10,0,10,3,0,3
26/02/2023 02:00,1,0,1,0,0,0,1,0,1,0,0,0,0,0,0,0,0,0,0,0,0,9,7,2,0,,14,0,14,8,0,8
26/02/2023 03:00,0,0,0,0,0,0,2,2,0,0,0,0,0,0,0,0,0,0,1,1,0,19,14,5,0,,14,1,13,7,0,7
26/02/2023 04:00,2,0,2,1,1,0,3,1,2,0,0,0,0,0,0,0,0,0,0,0,0,10,5,5,0,,4,0,4,2,0,2
26/02/2023 05:00,0,0,0,3,2,1,2,0,2,0,0,0,0,0,0,1,1,0,0,0,0,5,3,2,0,,5,0,5,2,0,2
26/02/2023 06:00,1,1,0,5,3,2,7,4,3,0,0,0,1,1,0,1,1,0,0,0,0,23,7,16,0,,5,0,5,6,0,6
26/02/2023 07:00,1,0,1,22,8,14,19,7,12,0,0,0,8,8,0,4,4,0,2,2,0,35,9,26,0,,6,0,6,10,0,10
26/02/2023 08:00,3,2,1,52,21,31,72,27,45,0,0,0,7,7,0,2,2,0,0,0,0,47,14,33,0,,6,0,6,12,0,12
26/02/2023 09:00,8,3,5,102,44,58,96,45,51,0,0,0,12,12,0,5,5,0,6,6,0,62,23,39,0,,16,0,16,30,0,30
26/02/2023 10:00,10,6,4,127,45,82,137,53,84,0,0,0,15,15,0,10,10,0,10,10,0,73,21,52,0,,27,0,27,37,0,37
26/02/2023 11:00,8,3,5,111,58,53,136,69,67,0,0,0,10,10,0,21,21,0,5,5,0,72,28,44,0,,25,0,25,55,1,54
26/02/2023 12:00,10,6,4,112,54,58,143,64,79,0,0,0,2,2,0,14,14,0,9,9,0,92,38,54,0,,54,0,54,84,1,83
26/02/2023 13:00,7,4,3,93,47,46,127,67,60,0,0,0,5,5,0,16,16,0,7,7,0,134,63,71,0,,59,0,59,73,0,73
26/02/2023 14:00,12,4,8,68,36,32,90,44,46,0,0,0,2,2,0,16,16,0,5,5,0,100,43,57,0,,62,0,62,70,0,70
26/02/2023 15:00,8,1,7,71,40,31,88,49,39,0,0,0,7,7,0,13,13,0,6,6,0,66,26,40,0,,69,0,69,78,0,78
26/02/2023 16:00,7,2,5,56,30,26,89,48,41,0,0,0,4,4,0,17,17,0,0,0,0,86,38,48,0,,61,0,61,73,0,73
26/02/2023 17:00,5,4,1,27,9,18,45,24,21,0,0,0,4,4,0,7,7,0,4,4,0,90,49,41,0,,71,0,71,36,0,36
26/02/2023 18:00,8,2,6,10,7,3,24,12,12,0,0,0,6,5,1,9,9,0,0,0,0,93,39,54,0,,76,1,75,70,0,70
26/02/2023 19:00,5,2,3,11,4,7,25,10,15,0,0,0,5,5,0,9,9,0,0,0,0,77,40,37,0,,61,0,61,78,0,78
26/02/2023 20:00,4,1,3,10,5,5,24,9,15,0,0,0,0,0,0,3,3,0,0,0,0,77,42,35,0,,49,0,49,48,0,48
26/02/2023 21:00,2,2,0,6,2,4,7,3,4,0,0,0,3,3,0,3,3,0,0,0,0,49,27,22,0,,40,0,40,46,2,44
26/02/2023 22:00,0,0,0,3,2,1,2,1,1,0,0,0,2,2,0,1,1,0,0,0,0,33,23,10,0,,32,0,32,29,0,29
26/02/2023 23:00,1,0,1,1,1,0,1,0,1,0,0,0,0,0,0,1,1,0,0,0,0,16,12,4,0,,21,0,21,7,0,7
27/02/2023 00:00,0,0,0,2,1,1,1,1,0,0,0,0,0,0,0,1,1,0,0,0,0,16,8,8,0,,16,0,16,7,0,7
27/02/2023 01:00,0,0,0,1,1,0,0,0,0,0,0,0,0,0,0,0,0,0,0,0,0,6,3,3,0,,4,1,3,0,0,0
27/02/2023 02:00,0,0,0,0,0,0,0,0,0,0,0,0,0,0,0,0,0,0,0,0,0,5,5,0,0,,8,0,8,3,0,3
27/02/2023 03:00,1,0,1,0,0,0,0,0,0,0,0,0,0,0,0,0,0,0,0,0,0,3,3,0,0,,3,0,3,2,0,2
27/02/2023 04:00,0,0,0,2,2,0,4,3,1,0,0,0,0,0,0,0,0,0,0,0,0,7,1,6,0,,0,0,0,0,0,0
27/02/2023 05:00,4,3,1,4,3,1,6,3,3,0,0,0,0,0,0,1,1,0,0,0,0,21,4,17,0,,2,0,2,8,0,8
27/02/2023 06:00,10,9,1,15,12,3,23,18,5,0,0,0,10,10,0,13,13,0,6,6,0,116,24,92,0,,12,0,12,23,0,23
27/02/2023 07:00,12,7,5,61,51,10,76,67,9,0,0,0,50,50,0,15,15,0,1,1,0,285,53,232,0,,32,0,32,80,0,80
27/02/2023 08:00,40,35,5,70,55,15,91,74,17,0,0,0,63,63,0,46,46,0,1,1,0,551,104,447,0,,58,0,58,156,0,156
27/02/2023 09:00,11,5,6,34,18,16,53,35,18,0,0,0,32,32,0,18,18,0,2,2,0,237,46,191,0,,27,0,27,112,1,111
27/02/2023 10:00,4,4,0,38,18,20,40,19,21,0,0,0,9,9,0,10,10,0,2,2,0,42,26,16,0,,17,0,17,54,0,54
27/02/2023 11:00,10,5,5,45,24,21,39,20,19,0,0,0,3,3,0,5,5,0,4,4,0,25,25,0,0,,33,0,33,49,1,48
27/02/2023 12:00,7,3,4,40,18,22,38,17,21,0,0,0,7,7,0,7,7,0,11,11,0,75,28,47,0,,56,0,56,60,1,59
27/02/2023 13:00,9,5,4,36,15,21,43,17,26,0,0,0,4,4,0,19,19,0,8,8,0,104,47,57,0,,74,0,74,75,0,75
27/02/2023 14:00,14,7,7,22,12,10,33,14,19,0,0,0,5,5,0,19,19,0,3,3,0,99,53,46,0,,54,0,54,45,0,45
27/02/2023 15:00,12,7,5,21,7,14,34,10,24,0,0,0,6,6,0,36,36,0,0,0,0,124,64,60,0,,72,0,72,47,0,47
27/02/2023 16:00,20,11,9,45,19,26,68,17,51,0,0,0,2,2,0,35,35,0,0,0,0,241,146,95,0,,106,0,106,41,0,41
27/02/2023 17:00,39,12,27,69,15,54,107,29,78,0,0,0,6,6,0,50,50,0,2,2,0,365,249,116,0,,199,0,199,85,0,85
27/02/2023 18:00,16,6,10,59,15,44,80,17,63,0,0,0,2,2,0,27,27,0,0,0,0,318,225,93,0,,185,0,185,102,0,102
27/02/2023 19:00,10,6,4,35,12,23,53,20,33,0,0,0,1,1,0,10,10,0,0,0,0,162,109,53,0,,115,1,114,62,0,62
27/02/2023 20:00,4,2,2,21,9,12,26,9,17,0,0,0,6,6,0,9,9,0,0,0,0,127,81,46,0,,84,1,83,74,1,73
27/02/2023 21:00,7,4,3,16,10,6,18,5,13,0,0,0,3,3,0,12,12,0,0,0,0,67,45,22,0,,71,0,71,54,1,53
27/02/2023 22:00,2,0,2,6,2,4,10,1,9,0,0,0,1,1,0,3,3,0,0,0,0,48,35,13,0,,35,0,35,30,0,30
27/02/2023 23:00,2,2,0,1,1,0,4,1,3,0,0,0,1,1,0,0,0,0,0,0,0,22,13,9,0,,30,0,30,8,0,8
28/02/2023 00:00,1,0,1,4,2,2,6,2,4,0,0,0,0,0,0,0,0,0,0,0,0,13,9,4,0,,19,1,18,5,0,5
28/02/2023 01:00,0,0,0,2,2,0,2,2,0,0,0,0,1,1,0,1,1,0,0,0,0,5,3,2,0,,5,0,5,0,0,0
28/02/2023 02:00,1,1,0,0,0,0,1,1,0,0,0,0,1,1,0,0,0,0,0,0,0,2,2,0,0,,3,0,3,1,0,1
28/02/2023 03:00,0,0,0,0,0,0,0,0,0,0,0,0,0,0,0,0,0,0,0,0,0,5,4,1,0,,1,0,1,3,0,3
28/02/2023 04:00,0,0,0,3,3,0,5,3,2,0,0,0,1,1,0,1,1,0,0,0,0,4,0,4,0,,1,0,1,2,0,2
28/02/2023 05:00,1,1,0,8,5,3,7,6,1,0,0,0,2,2,0,1,1,0,0,0,0,26,1,25,0,,2,0,2,6,0,6
28/02/2023 06:00,9,7,2,16,12,4,24,16,8,0,0,0,16,16,0,6,6,0,2,2,0,127,24,103,0,,11,0,11,26,0,26
28/02/2023 07:00,19,17,2,70,62,8,77,69,8,0,0,0,28,28,0,16,16,0,0,0,0,336,75,261,0,,38,2,36,85,0,85
28/02/2023 08:00,49,44,5,96,72,24,134,111,23,0,0,0,95,95,0,52,52,0,0,0,0,646,86,560,0,,56,1,55,186,0,186
28/02/2023 09:00,28,17,11,42,27,15,61,43,18,0,0,0,26,26,0,13,13,0,13,13,0,281,58,223,0,,36,0,36,134,0,134
28/02/2023 10:00,8,5,3,21,10,11,39,16,23,0,0,0,15,15,0,7,7,0,3,3,0,96,27,69,0,,21,0,21,63,0,63
28/02/2023 11:00,6,2,4,40,13,27,39,15,24,0,0,0,16,15,1,7,7,0,6,6,0,74,20,54,0,,27,0,27,50,0,50
28/02/2023 12:00,14,7,7,40,28,12,46,28,18,0,0,0,5,5,0,10,10,0,11,11,0,82,35,47,0,,60,0,60,76,0,76
28/02/2023 13:00,13,8,5,17,9,8,21,9,12,0,0,0,13,13,0,25,25,0,6,6,0,114,49,65,0,,86,0,86,69,0,69
28/02/2023 14:00,12,4,8,27,12,15,30,11,19,0,0,0,7,7,0,18,18,0,6,6,0,109,54,55,0,,67,0,67,76,1,75
28/02/2023 15:00,12,8,4,31,13,18,36,12,24,0,0,0,2,2,0,33,33,0,14,14,0,151,80,71,0,,76,0,76,60,1,59
28/02/2023 16:00,24,9,15,44,11,33,66,18,48,0,0,0,4,4,0,33,33,0,17,17,0,226,149,77,0,,130,0,130,83,0,83
28/02/2023 17:00,46,17,29,95,15,80,138,24,114,0,0,0,7,6,1,48,48,0,35,35,0,402,285,117,0,,226,1,225,79,0,79
28/02/2023 18:00,32,13,19,66,12,54,96,17,79,0,0,0,6,6,0,38,38,0,20,20,0,353,239,114,0,,197,0,197,88,0,88
28/02/2023 19:00,20,9,11,33,10,23,41,9,32,0,0,0,2,2,0,14,14,0,12,12,0,170,117,53,0,,117,0,117,83,0,83
28/02/2023 20:00,7,3,4,19,8,11,26,8,18,0,0,0,4,4,0,15,15,0,4,4,0,139,85,54,0,,80,0,80,67,0,67
28/02/2023 21:00,7,5,2,10,5,5,19,5,14,0,0,0,2,2,0,10,10,0,1,1,0,72,55,17,0,,59,0,59,58,0,58
28/02/2023 22:00,4,2,2,4,2,2,10,3,7,0,0,0,2,2,0,4,4,0,2,2,0,52,39,13,0,,35,0,35,29,1,28
28/02/2023 23:00,3,2,1,2,0,2,2,1,1,0,0,0,1,1,0,2,2,0,0,0,0,24,20,4,0,,42,1,41,7,0,7
1/3/2023 0:00,2,1,1,0,0,0,0,0,0,0,0,0,1,0,1,0,0,0,0,0,0,22,12,10,0,,15,0,15,8,0,8
1/3/2023 1:00,0,0,0,2,1,1,0,0,0,0,0,0,0,0,0,0,0,0,0,0,0,7,3,4,0,,1,0,1,1,0,1
1/3/2023 2:00,1,0,1,0,0,0,3,2,1,0,0,0,0,0,0,0,0,0,0,0,0,5,4,1,0,,3,0,3,5,0,5
1/3/2023 3:00,0,0,0,1,0,1,1,0,1,0,0,0,0,0,0,0,0,0,0,0,0,5,2,3,0,,4,1,3,1,0,1
1/3/2023 4:00,0,0,0,2,2,0,4,1,3,0,0,0,1,1,0,0,0,0,2,2,0,6,1,5,0,,1,0,1,1,0,1
1/3/2023 5:00,2,2,0,6,4,2,8,5,3,0,0,0,1,1,0,1,1,0,0,0,0,27,2,25,0,,4,0,4,11,0,11
1/3/2023 6:00,11,11,0,14,10,4,19,15,4,0,0,0,8,8,0,7,7,0,4,4,0,118,26,92,0,,9,0,9,28,0,28
1/3/2023 7:00,38,31,7,69,61,8,85,74,11,0,0,0,25,25,0,12,12,0,28,28,0,307,49,258,0,,38,0,38,79,0,79
1/3/2023 8:00,96,86,10,78,64,14,112,97,15,0,0,0,77,75,2,47,47,0,121,121,0,688,96,592,0,,59,0,59,208,2,206
1/3/2023 9:00,33,27,6,27,18,9,39,28,11,0,0,0,21,21,0,12,12,0,22,22,0,265,49,216,0,,28,1,27,119,1,118
1/3/2023 10:00,16,13,3,21,10,11,36,15,21,0,0,0,16,16,0,7,7,0,8,8,0,81,25,56,0,,32,1,31,55,0,55
1/3/2023 11:00,12,8,4,35,19,16,49,27,22,0,0,0,18,18,0,11,11,0,5,5,0,76,23,53,0,,38,0,38,66,1,65
1/3/2023 12:00,17,9,8,35,17,18,51,30,21,0,0,0,4,4,0,10,10,0,12,12,0,97,36,61,0,,70,0,70,80,1,79
1/3/2023 13:00,19,9,10,47,21,26,65,30,35,0,0,0,5,5,0,22,22,0,7,7,0,115,58,57,0,,70,0,70,95,1,94
1/3/2023 14:00,28,14,14,28,13,15,46,19,27,0,0,0,7,7,0,18,18,0,20,20,0,117,51,66,0,,58,0,58,55,0,55
1/3/2023 15:00,20,11,9,34,14,20,47,16,31,0,0,0,9,9,0,32,32,0,11,11,0,142,70,72,0,,82,0,82,59,0,59
1/3/2023 16:00,35,11,24,44,18,26,59,19,40,0,0,0,9,9,0,38,38,0,16,16,0,242,148,94,0,,149,0,149,69,0,69
1/3/2023 17:00,54,15,39,94,15,79,145,26,119,0,0,0,5,5,0,45,45,0,32,32,0,446,314,132,0,,203,0,203,119,0,119
1/3/2023 18:00,37,8,29,91,22,69,124,28,96,0,0,0,4,4,0,41,41,0,17,17,0,368,264,104,0,,228,2,226,126,0,126
1/3/2023 19:00,23,5,18,53,17,36,71,29,42,0,0,0,2,2,0,17,17,0,9,9,0,217,140,77,0,,134,0,134,103,1,102
1/3/2023 20:00,11,5,6,25,10,15,23,7,16,0,0,0,5,5,0,14,14,0,17,17,0,123,77,46,0,,95,1,94,94,2,92
1/3/2023 21:00,12,5,7,7,3,4,22,6,16,0,0,0,6,6,0,7,7,0,6,6,0,84,58,26,0,,86,1,85,69,0,69
1/3/2023 22:00,3,2,1,6,2,4,12,2,10,0,0,0,0,0,0,6,6,0,1,1,0,60,39,21,0,,60,0,60,36,0,36
1/3/2023 23:00,4,2,2,4,2,2,5,0,5,0,0,0,0,0,0,2,2,0,0,0,0,39,30,9,0,,36,1,35,16,0,16
2/3/2023 0:00,2,1,1,0,0,0,2,0,2,0,0,0,0,0,0,2,2,0,0,0,0,24,13,11,0,,12,0,12,9,0,9
2/3/2023 1:00,0,0,0,1,1,0,1,1,0,0,0,0,0,0,0,0,0,0,0,0,0,5,4,1,0,,2,0,2,2,0,2
2/3/2023 2:00,0,0,0,0,0,0,0,0,0,0,0,0,1,1,0,0,0,0,0,0,0,5,5,0,0,,6,0,6,2,0,2
2/3/2023 3:00,1,0,1,0,0,0,0,0,0,0,0,0,1,1,0,0,0,0,0,0,0,4,2,2,0,,4,0,4,2,0,2
2/3/2023 4:00,0,0,0,2,2,0,3,1,2,0,0,0,1,1,0,1,1,0,1,1,0,5,1,4,0,,4,0,4,1,0,1
2/3/2023 5:00,3,3,0,5,3,2,4,3,1,0,0,0,0,0,0,1,1,0,0,0,0,32,5,27,0,,4,0,4,6,0,6
2/3/2023 6:00,9,9,0,14,13,1,20,15,5,0,0,0,11,11,0,10,10,0,7,7,0,120,22,98,0,,9,0,9,22,0,22
2/3/2023 7:00,34,28,6,53,43,10,65,51,14,0,0,0,20,20,0,15,15,0,20,20,0,273,65,208,0,,39,1,38,72,1,71
2/3/2023 8:00,88,73,15,74,58,16,104,87,17,0,0,0,83,83,0,43,43,0,112,112,0,630,105,525,0,,47,0,47,199,1,198
2/3/2023 9:00,36,29,7,30,22,8,50,36,14,0,0,0,24,24,0,12,12,0,8,8,0,277,45,232,0,,30,0,30,140,0,140
2/3/2023 10:00,11,9,2,26,14,12,30,17,13,0,0,0,4,4,0,10,10,0,7,7,0,105,35,70,0,,24,0,24,75,0,75
2/3/2023 11:00,8,5,3,36,17,19,41,17,24,0,0,0,12,12,0,6,6,0,7,7,0,86,31,55,0,,33,0,33,61,1,60
2/3/2023 12:00,10,6,4,34,18,16,40,17,23,0,0,0,8,8,0,7,7,0,8,8,0,90,40,50,0,,58,0,58,85,1,84
2/3/2023 13:00,14,8,6,28,11,17,36,15,21,0,0,0,5,5,0,13,13,0,8,8,0,136,63,73,0,,79,1,78,93,0,93
2/3/2023 14:00,7,5,2,28,13,15,43,15,28,0,0,0,6,6,0,23,23,0,12,12,0,84,40,44,0,,74,0,74,51,0,51
2/3/2023 15:00,13,7,6,32,17,15,35,16,19,0,0,0,4,4,0,38,38,0,16,16,0,133,77,56,0,,77,0,77,81,0,81
2/3/2023 16:00,26,4,22,51,13,38,75,21,54,0,0,0,5,5,0,40,40,0,18,18,0,200,123,77,0,,99,1,98,65,0,65
2/3/2023 17:00,54,19,35,75,19,56,123,32,91,0,0,0,1,1,0,34,34,0,18,18,0,378,261,117,0,,180,0,180,103,1,102
2/3/2023 18:00,41,12,29,91,29,62,109,31,78,0,0,0,5,5,0,26,26,0,13,13,0,362,243,119,0,,151,1,150,120,1,119
2/3/2023 19:00,21,9,12,41,8,33,49,15,34,0,0,0,4,4,0,17,17,0,11,11,0,199,120,79,0,,111,1,110,64,0,64
2/3/2023 20:00,15,3,12,28,14,14,37,19,18,0,0,0,5,5,0,14,14,0,6,6,0,122,73,49,0,,83,1,82,77,0,77
2/3/2023 21:00,10,4,6,15,9,6,16,7,9,0,0,0,3,3,0,18,18,0,5,5,0,105,64,41,0,,72,0,72,53,0,53
2/3/2023 22:00,4,3,1,7,2,5,18,4,14,0,0,0,3,3,0,6,6,0,2,2,0,61,43,18,0,,43,0,43,32,0,32
2/3/2023 23:00,5,3,2,4,0,4,5,1,4,0,0,0,3,3,0,5,5,0,2,2,0,45,33,12,0,,33,0,33,16,0,16
3/3/2023 0:00,1,0,1,1,0,1,4,1,3,0,0,0,0,0,0,2,2,0,0,0,0,29,21,8,0,,34,0,34,6,0,6
3/3/2023 1:00,1,1,0,4,2,2,2,2,0,0,0,0,0,0,0,0,0,0,0,0,0,9,7,2,0,,6,0,6,0,0,0
3/3/2023 2:00,2,2,0,1,0,1,1,0,1,0,0,0,0,0,0,0,0,0,1,1,0,8,8,0,0,,6,0,6,4,1,3
3/3/2023 3:00,2,0,2,0,0,0,0,0,0,0,0,0,0,0,0,0,0,0,0,0,0,2,1,1,0,,9,0,9,2,0,2
3/3/2023 4:00,0,0,0,1,1,0,3,1,2,0,0,0,0,0,0,0,0,0,2,2,0,9,6,3,0,,4,0,4,1,0,1
3/3/2023 5:00,3,3,0,6,4,2,6,4,2,0,0,0,1,1,0,1,1,0,3,3,0,32,6,26,0,,3,0,3,7,0,7
3/3/2023 6:00,7,7,0,13,10,3,18,9,9,0,0,0,7,7,0,13,13,0,1,1,0,112,26,86,0,,6,0,6,25,0,25
3/3/2023 7:00,22,20,2,40,29,11,55,41,14,0,0,0,28,28,0,8,8,0,12,12,0,192,46,146,0,,25,0,25,53,0,53
3/3/2023 8:00,66,58,8,70,52,18,92,65,27,0,0,0,55,54,1,47,47,0,82,82,0,403,73,330,0,,39,0,39,115,2,113
3/3/2023 9:00,24,20,4,47,23,24,60,36,24,0,0,0,17,17,0,7,7,0,15,15,0,212,45,167,0,,32,1,31,122,0,122
3/3/2023 10:00,14,9,5,37,20,17,47,26,21,0,0,0,15,15,0,10,10,0,4,4,0,80,19,61,0,,29,1,28,51,0,51
3/3/2023 11:00,12,6,6,48,28,20,50,28,22,0,0,0,4,4,0,8,8,0,4,4,0,95,30,65,0,,44,1,43,66,0,66
3/3/2023 12:00,20,9,11,35,16,19,36,17,19,0,0,0,7,7,0,10,10,0,5,5,0,108,44,64,0,,49,0,49,89,2,87
3/3/2023 13:00,14,3,11,34,17,17,43,21,22,0,0,0,3,3,0,26,26,0,6,6,0,146,68,78,0,,56,0,56,95,1,94
3/3/2023 14:00,18,9,9,35,15,20,46,18,28,0,0,0,8,8,0,19,19,0,10,10,0,117,54,63,0,,77,1,76,73,0,73
3/3/2023 15:00,22,10,12,42,21,21,42,19,23,0,0,0,4,4,0,18,18,0,13,13,0,155,89,66,0,,79,0,79,72,0,72
3/3/2023 16:00,22,9,13,49,21,28,58,21,37,0,0,0,0,0,0,23,23,0,16,16,0,210,121,89,0,,100,0,100,70,0,70
3/3/2023 17:00,42,9,33,68,21,47,93,28,65,0,0,0,4,4,0,40,40,0,8,8,0,264,172,92,0,,129,1,128,109,1,108
3/3/2023 18:00,22,12,10,45,14,31,64,19,45,0,0,0,4,4,0,19,19,0,5,5,0,210,132,78,0,,144,0,144,81,0,81
3/3/2023 19:00,12,6,6,15,4,11,26,8,18,0,0,0,9,9,0,13,13,0,8,8,0,170,92,78,0,,101,0,101,95,1,94
3/3/2023 20:00,3,2,1,10,4,6,14,4,10,0,0,0,4,4,0,7,7,0,4,4,0,112,73,39,0,,71,0,71,89,1,88
3/3/2023 21:00,11,7,4,5,1,4,14,2,12,0,0,0,5,5,0,3,3,0,3,3,0,91,56,35,0,,54,0,54,72,0,72
3/3/2023 22:00,3,1,2,6,3,3,12,4,8,0,0,0,1,1,0,4,4,0,3,3,0,33,24,9,0,,35,0,35,35,0,35
3/3/2023 23:00,4,3,1,5,1,4,7,2,5,0,0,0,0,0,0,4,4,0,4,4,0,42,31,11,0,,33,0,33,29,0,29
4/3/2023 0:00,1,0,1,1,1,0,8,5,3,0,0,0,0,0,0,1,1,0,0,0,0,29,16,13,0,,22,0,22,15,0,15
4/3/2023 1:00,1,1,0,6,4,2,2,1,1,0,0,0,1,1,0,1,1,0,2,2,0,16,12,4,0,,6,0,6,1,0,1
4/3/2023 2:00,0,0,0,2,1,1,0,0,0,0,0,0,1,1,0,1,1,0,0,0,0,7,5,2,0,,17,0,17,9,0,9
4/3/2023 3:00,0,0,0,1,0,1,2,0,2,0,0,0,0,0,0,0,0,0,0,0,0,6,3,3,0,,11,0,11,3,0,3
4/3/2023 4:00,2,0,2,1,1,0,1,1,0,0,0,0,0,0,0,0,0,0,0,0,0,11,10,1,0,,5,0,5,4,0,4
4/3/2023 5:00,0,0,0,1,0,1,2,0,2,0,0,0,2,2,0,1,1,0,1,1,0,8,3,5,0,,2,0,2,2,0,2
4/3/2023 6:00,3,3,0,7,4,3,6,4,2,0,0,0,3,3,0,4,4,0,1,1,0,29,6,23,0,,6,0,6,11,0,11
4/3/2023 7:00,3,2,1,24,11,13,22,11,11,0,0,0,10,10,0,1,1,0,4,4,0,44,14,30,0,,5,0,5,13,0,13
4/3/2023 8:00,10,7,3,43,17,26,47,20,27,0,0,0,11,11,0,5,5,0,4,4,0,67,16,51,0,,16,0,16,36,0,36
4/3/2023 9:00,6,3,3,89,35,54,111,42,69,0,0,0,13,13,0,10,10,0,11,11,0,85,26,59,0,,13,0,13,44,0,44
4/3/2023 10:00,18,7,11,109,51,58,136,63,73,0,0,0,11,11,0,9,9,0,10,10,0,72,27,45,0,,32,0,32,57,0,57
4/3/2023 11:00,7,6,1,127,65,62,140,85,55,0,0,0,1,1,0,9,9,0,18,18,0,81,20,61,0,,58,0,58,75,3,72
4/3/2023 12:00,9,5,4,93,47,46,119,68,51,0,0,0,2,2,0,15,15,0,9,9,0,109,40,69,0,,60,0,60,86,0,86
4/3/2023 13:00,13,7,6,64,38,26,96,46,50,0,0,0,2,2,0,14,14,0,11,11,0,112,47,65,0,,85,0,85,84,0,84
4/3/2023 14:00,17,10,7,68,30,38,99,50,49,0,0,0,2,2,0,7,7,0,9,9,0,96,35,61,0,,79,1,78,97,1,96
4/3/2023 15:00,9,3,6,70,40,30,74,41,33,0,0,0,1,1,0,15,15,0,9,9,0,108,49,59,0,,68,0,68,95,0,95
4/3/2023 16:00,16,8,8,58,31,27,68,34,34,0,0,0,2,1,1,12,12,0,8,8,0,119,52,67,0,,75,0,75,79,0,79
4/3/2023 17:00,8,4,4,38,24,14,49,24,25,0,0,0,5,5,0,6,6,0,7,7,0,93,45,48,0,,86,0,86,88,1,87
4/3/2023 18:00,9,4,5,14,6,8,23,13,10,0,0,0,4,4,0,7,7,0,4,4,0,122,61,61,0,,82,0,82,94,0,94
4/3/2023 19:00,9,4,5,16,8,8,25,12,13,0,0,0,4,4,0,6,6,0,3,3,0,108,52,56,0,,67,0,67,107,0,107
4/3/2023 20:00,6,4,2,8,3,5,9,2,7,0,0,0,5,5,0,3,3,0,7,7,0,70,33,37,0,,55,0,55,83,1,82
4/3/2023 21:00,5,3,2,7,5,2,10,6,4,0,0,0,4,4,0,2,2,0,2,2,0,50,20,30,0,,38,0,38,67,2,65
4/3/2023 22:00,6,2,4,2,1,1,6,3,3,0,0,0,3,2,1,4,4,0,2,2,0,40,26,14,0,,19,0,19,30,0,30
4/3/2023 23:00,3,1,2,6,4,2,7,1,6,0,0,0,0,0,0,1,1,0,0,0,0,39,28,11,0,,28,1,27,16,0,16
5/3/2023 0:00,0,0,0,3,1,2,4,0,4,0,0,0,1,1,0,0,0,0,1,1,0,29,22,7,0,,20,0,20,18,0,18
5/3/2023 1:00,0,0,0,7,3,4,3,1,2,0,0,0,0,0,0,1,1,0,1,1,0,23,16,7,0,,5,0,5,2,0,2
5/3/2023 2:00,2,1,1,2,2,0,3,2,1,0,0,0,0,0,0,0,0,0,0,0,0,16,10,6,0,,13,0,13,8,0,8
5/3/2023 3:00,1,1,0,0,0,0,1,0,1,0,0,0,0,0,0,0,0,0,1,1,0,17,10,7,0,,18,1,17,3,0,3
5/3/2023 4:00,1,1,0,0,0,0,1,0,1,0,0,0,0,0,0,2,2,0,0,0,0,7,6,1,0,,6,0,6,3,0,3
5/3/2023 5:00,1,0,1,2,0,2,2,0,2,0,0,0,0,0,0,1,1,0,1,1,0,9,4,5,0,,6,0,6,2,0,2
5/3/2023 6:00,1,0,1,2,1,1,2,1,1,0,0,0,2,2,0,2,2,0,0,0,0,19,6,13,0,,3,0,3,2,0,2
5/3/2023 7:00,3,2,1,18,9,9,21,8,13,0,0,0,14,14,0,3,3,0,4,4,0,35,12,23,0,,6,0,6,11,0,11
5/3/2023 8:00,3,1,2,96,42,54,95,37,58,0,0,0,4,4,0,4,4,0,3,3,0,41,15,26,0,,5,0,5,10,0,10
5/3/2023 9:00,12,8,4,110,48,62,112,46,66,0,0,0,9,9,0,15,15,0,9,9,0,69,21,48,0,,14,0,14,34,0,34
5/3/2023 10:00,12,10,2,148,67,81,173,59,114,0,0,0,6,6,0,13,13,0,7,7,0,86,26,60,0,,25,0,25,39,0,39
5/3/2023 11:00,13,8,5,165,75,90,187,82,105,0,0,0,7,7,0,15,15,0,7,7,0,100,35,65,0,,39,0,39,40,0,40
5/3/2023 12:00,17,4,13,148,88,60,207,115,92,0,0,0,1,1,0,13,13,0,13,13,0,108,43,65,0,,47,0,47,63,1,62
5/3/2023 13:00,17,9,8,119,64,55,144,81,63,0,0,0,3,3,0,12,12,0,10,10,0,104,43,61,0,,47,0,47,76,0,76
5/3/2023 14:00,14,7,7,88,53,35,98,54,44,0,0,0,6,5,1,16,16,0,9,9,0,99,40,59,0,,41,0,41,88,0,88
5/3/2023 15:00,13,8,5,98,52,46,124,69,55,0,0,0,2,2,0,12,12,0,9,9,0,90,42,48,0,,67,0,67,73,1,72
5/3/2023 16:00,10,5,5,77,48,29,90,49,41,0,0,0,3,3,0,8,8,0,15,15,0,108,43,65,0,,65,0,65,66,1,65
5/3/2023 17:00,12,6,6,35,22,13,60,33,27,0,0,0,3,3,0,14,14,0,6,6,0,84,40,44,0,,66,0,66,62,0,62
5/3/2023 18:00,8,6,2,26,17,9,29,17,12,0,0,0,6,6,0,6,6,0,6,6,0,110,56,54,0,,99,0,99,88,3,85
5/3/2023 19:00,13,5,8,14,5,9,26,13,13,0,0,0,6,6,0,5,5,0,4,4,0,104,56,48,0,,78,0,78,92,1,91
5/3/2023 20:00,9,4,5,11,5,6,15,8,7,0,0,0,9,9,0,6,6,0,1,1,0,66,44,22,0,,67,0,67,85,0,85
5/3/2023 21:00,8,5,3,1,0,1,3,2,1,0,0,0,3,3,0,3,3,0,0,0,0,51,25,26,0,,44,0,44,73,2,71
5/3/2023 22:00,7,3,4,5,2,3,5,3,2,0,0,0,4,4,0,1,1,0,0,0,0,33,20,13,0,,21,0,21,28,0,28
5/3/2023 23:00,2,1,1,4,2,2,5,4,1,0,0,0,1,1,0,0,0,0,0,0,0,25,18,7,0,,19,0,19,16,0,16
6/3/2023 0:00,1,1,0,1,0,1,2,0,2,0,0,0,1,1,0,2,2,0,1,1,0,19,12,7,0,,14,0,14,7,0,7
6/3/2023 1:00,0,0,0,2,2,0,2,2,0,0,0,0,0,0,0,1,1,0,0,0,0,7,7,0,0,,4,0,4,0,0,0
6/3/2023 2:00,1,1,0,0,0,0,0,0,0,0,0,0,0,0,0,0,0,0,0,0,0,2,2,0,0,,6,1,5,4,0,4
6/3/2023 3:00,0,0,0,0,0,0,0,0,0,0,0,0,0,0,0,0,0,0,1,1,0,3,0,3,0,,3,0,3,1,0,1
6/3/2023 4:00,1,0,1,1,1,0,1,0,1,0,0,0,1,0,1,0,0,0,0,0,0,4,0,4,0,,0,0,0,0,0,0
6/3/2023 5:00,4,4,0,3,2,1,4,2,2,0,0,0,1,1,0,1,1,0,0,0,0,31,4,27,0,,3,0,3,9,0,9
6/3/2023 6:00,14,13,1,15,12,3,23,18,5,0,0,0,17,17,0,9,9,0,2,2,0,125,29,96,0,,10,0,10,20,0,20
6/3/2023 7:00,32,27,5,54,45,9,59,54,5,0,0,0,26,26,0,16,16,0,12,12,0,275,57,218,0,,25,0,25,63,0,63
6/3/2023 8:00,83,73,10,79,61,18,109,89,20,0,0,0,67,67,0,53,53,0,105,105,0,477,77,400,0,,48,1,47,185,0,185
6/3/2023 9:00,41,28,13,34,19,15,47,26,21,0,0,0,18,18,0,10,10,0,16,16,0,234,45,189,0,,32,1,31,110,0,110
6/3/2023 10:00,9,9,0,42,22,20,44,18,26,0,0,0,11,11,0,10,10,0,9,9,0,90,27,63,0,,19,0,19,57,0,57
6/3/2023 11:00,12,7,5,30,12,18,43,21,22,0,0,0,1,1,0,7,7,0,3,3,0,62,20,42,0,,26,0,26,40,2,38
6/3/2023 12:00,12,5,7,22,16,6,25,13,12,0,0,0,2,1,1,4,4,0,9,9,0,82,31,51,0,,52,0,52,61,0,61
6/3/2023 13:00,11,6,5,20,9,11,27,11,16,0,0,0,1,1,0,13,13,0,8,8,0,82,45,37,0,,62,0,62,64,1,63
6/3/2023 14:00,7,2,5,7,4,3,12,4,8,0,0,0,2,2,0,13,13,0,10,10,0,78,37,41,0,,53,0,53,39,0,39
6/3/2023 15:00,8,6,2,8,1,7,23,4,19,0,0,0,1,1,0,41,41,0,12,12,0,118,69,49,0,,61,0,61,44,0,44
6/3/2023 16:00,19,9,10,28,8,20,40,10,30,0,0,0,2,2,0,35,35,0,8,8,0,184,117,67,0,,91,0,91,39,0,39
6/3/2023 17:00,41,11,30,46,5,41,70,7,63,0,0,0,4,4,0,31,31,0,4,4,0,323,232,91,0,,158,2,156,60,1,59
6/3/2023 18:00,34,6,28,40,6,34,54,4,50,0,0,0,0,0,0,27,27,0,2,2,0,247,166,81,0,,171,0,171,63,0,63
6/3/2023 19:00,12,6,6,17,4,13,35,10,25,0,0,0,0,0,0,9,9,0,6,6,0,144,95,49,0,,95,1,94,53,0,53
6/3/2023 20:00,8,1,7,12,2,10,11,2,9,0,0,0,2,2,0,7,7,0,3,3,0,95,67,28,0,,71,1,70,52,0,52
6/3/2023 21:00,7,3,4,6,3,3,9,2,7,0,0,0,2,2,0,9,9,0,4,4,0,69,45,24,0,,43,0,43,41,1,40
6/3/2023 22:00,3,2,1,1,1,0,6,1,5,0,0,0,0,0,0,1,1,0,1,1,0,43,33,10,0,,33,1,32,28,0,28
6/3/2023 23:00,5,3,2,1,0,1,1,0,1,0,0,0,1,1,0,2,2,0,0,0,0,19,13,6,0,,12,0,12,14,0,14
7/3/2023 0:00,4,2,2,0,0,0,1,0,1,0,0,0,2,2,0,1,1,0,0,0,0,11,6,5,0,,9,0,9,7,0,7
7/3/2023 1:00,0,0,0,1,1,0,3,2,1,0,0,0,0,0,0,1,1,0,0,0,0,3,3,0,0,,0,0,0,0,0,0
7/3/2023 2:00,0,0,0,1,1,0,1,1,0,0,0,0,0,0,0,0,0,0,0,0,0,4,3,1,0,,1,0,1,2,0,2
7/3/2023 3:00,1,0,1,0,0,0,0,0,0,0,0,0,0,0,0,0,0,0,1,1,0,2,0,2,0,,1,0,1,0,0,0
7/3/2023 4:00,1,1,0,3,2,1,4,0,4,0,0,0,2,2,0,0,0,0,0,0,0,7,0,7,0,,3,0,3,1,0,1
7/3/2023 5:00,1,1,0,3,2,1,5,3,2,0,0,0,1,1,0,1,1,0,0,0,0,25,4,21,0,,3,0,3,6,0,6
7/3/2023 6:00,16,11,5,14,11,3,21,17,4,0,0,0,10,10,0,10,10,0,2,2,0,104,18,86,0,,10,0,10,26,0,26
7/3/2023 7:00,46,43,3,55,51,4,69,62,7,0,0,0,28,28,0,13,13,0,9,9,0,326,57,269,0,,28,0,28,71,0,71
7/3/2023 8:00,94,80,14,74,61,13,108,95,13,0,0,0,81,81,0,56,56,0,97,97,0,636,88,548,0,,47,0,47,208,0,208
7/3/2023 9:00,41,33,8,42,22,20,55,32,23,0,0,0,17,17,0,20,20,0,19,19,0,246,51,195,0,,40,1,39,142,1,141
7/3/2023 10:00,6,3,3,47,21,26,47,19,28,0,0,0,14,13,1,7,7,0,5,5,0,70,17,53,0,,30,0,30,52,0,52
7/3/2023 11:00,3,0,3,54,25,29,74,32,42,0,0,0,6,5,1,9,9,0,6,6,0,77,19,58,0,,34,0,34,53,1,52
7/3/2023 12:00,19,12,7,64,28,36,74,32,42,0,0,0,4,4,0,7,7,0,8,8,0,113,42,71,0,,46,0,46,79,1,78
7/3/2023 13:00,23,8,15,55,27,28,58,30,28,0,0,0,3,3,0,13,13,0,7,7,0,117,58,59,0,,61,1,60,72,1,71
7/3/2023 14:00,17,7,10,53,21,32,84,36,48,0,0,0,9,9,0,17,17,0,12,12,0,98,52,46,0,,66,0,66,55,1,54
7/3/2023 15:00,19,12,7,46,24,22,60,23,37,0,0,0,7,7,0,47,47,0,11,11,0,141,85,56,0,,74,0,74,57,0,57
7/3/2023 16:00,23,7,16,55,19,36,83,30,53,0,0,0,3,3,0,37,37,0,21,21,0,234,140,94,0,,127,0,127,74,0,74
7/3/2023 17:00,56,17,39,97,25,72,155,37,118,0,0,0,2,2,0,39,39,0,20,20,0,400,300,100,0,,231,0,231,93,0,93
7/3/2023 18:00,42,15,27,89,29,60,99,23,76,0,0,0,2,2,0,27,27,0,8,8,0,335,221,114,0,,202,0,202,77,0,77
7/3/2023 19:00,22,7,15,47,19,28,61,23,38,0,0,0,5,5,0,22,22,0,5,5,0,208,134,74,0,,114,0,114,87,0,87
7/3/2023 20:00,9,4,5,24,11,13,24,8,16,0,0,0,2,2,0,15,15,0,6,6,0,144,95,49,0,,98,0,98,63,0,63
7/3/2023 21:00,9,2,7,11,4,7,13,3,10,0,0,0,0,0,0,8,8,0,2,2,0,74,48,26,0,,47,1,46,24,0,24
7/3/2023 22:00,9,4,5,8,2,6,15,5,10,0,0,0,2,2,0,2,2,0,3,3,0,57,35,22,0,,42,0,42,17,0,17
7/3/2023 23:00,4,3,1,4,3,1,4,1,3,0,0,0,1,1,0,1,1,0,0,0,0,27,20,7,0,,38,0,38,9,0,9
8/3/2023 0:00,0,0,0,0,0,0,1,1,0,0,0,0,1,1,0,0,0,0,0,0,0,14,8,6,0,,18,0,18,8,0,8
8/3/2023 1:00,1,0,1,2,1,1,0,0,0,0,0,0,1,1,0,1,1,0,1,1,0,5,5,0,0,,1,0,1,0,0,0
8/3/2023 2:00,2,0,2,0,0,0,0,0,0,0,0,0,0,0,0,0,0,0,0,0,0,2,2,0,0,,2,0,2,2,0,2
8/3/2023 3:00,0,0,0,1,1,0,4,1,3,0,0,0,0,0,0,0,0,0,0,0,0,7,4,3,0,,3,0,3,0,0,0
8/3/2023 4:00,1,1,0,2,2,0,1,0,1,0,0,0,2,2,0,0,0,0,1,1,0,5,0,5,0,,1,0,1,3,0,3
8/3/2023 5:00,2,1,1,5,3,2,5,3,2,0,0,0,2,2,0,1,1,0,0,0,0,29,2,27,0,,3,0,3,12,0,12
8/3/2023 6:00,16,14,2,11,8,3,21,16,5,0,0,0,11,11,0,7,7,0,4,4,0,102,17,85,0,,10,0,10,22,0,22
8/3/2023 7:00,45,37,8,46,40,6,63,58,5,0,0,0,21,21,0,15,15,0,21,21,0,304,62,242,0,,32,0,32,75,0,75
8/3/2023 8:00,100,87,13,86,73,13,114,93,21,0,0,0,58,58,0,52,52,0,123,123,0,630,89,541,0,,54,0,54,180,0,180
8/3/2023 9:00,30,23,7,29,20,9,42,29,13,0,0,0,27,26,1,7,7,0,19,19,0,274,37,237,0,,29,1,28,138,0,138
8/3/2023 10:00,12,8,4,27,13,14,32,15,17,0,0,0,11,11,0,14,14,0,5,5,0,80,22,58,0,,21,0,21,52,0,52
8/3/2023 11:00,10,6,4,37,23,14,37,24,13,0,0,0,5,5,0,7,7,0,6,6,0,77,21,56,0,,39,0,39,66,2,64
8/3/2023 12:00,19,13,6,30,17,13,32,16,16,0,0,0,14,14,0,13,13,0,5,5,0,102,35,67,0,,70,0,70,79,1,78
8/3/2023 13:00,14,7,7,36,20,16,34,17,17,0,0,0,7,7,0,17,17,0,10,10,0,133,61,72,0,,75,1,74,82,0,82
8/3/2023 14:00,13,6,7,24,13,11,30,14,16,0,0,0,5,5,0,20,20,0,15,15,0,104,52,52,0,,85,0,85,47,0,47
8/3/2023 15:00,12,10,2,26,7,19,38,12,26,0,0,0,5,5,0,40,40,0,14,14,0,159,85,74,0,,70,0,70,59,0,59
8/3/2023 16:00,28,9,19,28,9,19,43,13,30,0,0,0,2,2,0,24,24,0,14,14,0,249,157,92,0,,115,0,115,73,1,72
8/3/2023 17:00,60,13,47,60,10,50,81,11,70,0,0,0,2,2,0,34,34,0,17,17,0,390,282,108,0,,231,1,230,103,1,102
8/3/2023 18:00,33,13,20,46,7,39,65,13,52,0,0,0,1,1,0,28,28,0,16,16,0,351,248,103,0,,186,0,186,80,0,80
8/3/2023 19:00,26,11,15,25,3,22,33,6,27,0,0,0,1,1,0,10,10,0,8,8,0,160,98,62,0,,88,0,88,64,1,63
8/3/2023 20:00,11,4,7,11,4,7,18,7,11,0,0,0,3,3,0,13,13,0,5,5,0,116,73,43,0,,82,0,82,58,0,58
8/3/2023 21:00,8,1,7,4,2,2,11,2,9,0,0,0,1,1,0,6,6,0,0,0,0,93,58,35,0,,78,0,78,48,0,48
8/3/2023 22:00,4,2,2,0,0,0,2,0,2,0,0,0,1,1,0,3,3,0,1,1,0,67,50,17,0,,40,0,40,32,0,32
8/3/2023 23:00,2,1,1,1,0,1,2,0,2,0,0,0,0,0,0,2,2,0,2,2,0,22,19,3,0,,30,0,30,13,0,13
9/3/2023 0:00,0,0,0,0,0,0,0,0,0,0,0,0,1,1,0,0,0,0,0,0,0,10,5,5,0,,15,0,15,6,0,6
9/3/2023 1:00,0,0,0,1,1,0,0,0,0,0,0,0,0,0,0,2,2,0,0,0,0,4,2,2,0,,1,0,1,0,0,0
9/3/2023 2:00,0,0,0,0,0,0,0,0,0,0,0,0,0,0,0,0,0,0,0,0,0,4,3,1,0,,3,0,3,4,0,4
9/3/2023 3:00,0,0,0,0,0,0,0,0,0,0,0,0,0,0,0,0,0,0,0,0,0,2,2,0,0,,4,0,4,1,0,1
9/3/2023 4:00,0,0,0,1,1,0,1,0,1,0,0,0,2,2,0,0,0,0,0,0,0,7,2,5,0,,1,0,1,0,0,0
9/3/2023 5:00,1,1,0,2,1,1,2,1,1,0,0,0,2,2,0,1,1,0,0,0,0,22,2,20,0,,3,0,3,8,0,8
9/3/2023 6:00,14,13,1,4,4,0,9,8,1,0,0,0,8,8,0,7,7,0,0,0,0,86,21,65,0,,5,0,5,14,0,14
9/3/2023 7:00,26,21,5,20,17,3,29,26,3,0,0,0,20,20,0,14,14,0,3,3,0,202,47,155,0,,25,0,25,45,0,45
9/3/2023 8:00,60,55,5,34,28,6,43,39,4,0,0,0,52,52,0,25,25,0,4,4,0,414,72,342,0,,39,0,39,87,1,86
9/3/2023 9:00,25,17,8,10,8,2,17,14,3,0,0,0,21,21,0,10,10,0,1,1,0,176,30,146,0,,25,0,25,76,0,76
9/3/2023 10:00,5,3,2,6,4,2,8,4,4,0,0,0,7,6,1,8,8,0,0,0,0,59,22,37,0,,16,0,16,29,0,29
9/3/2023 11:00,5,4,1,7,4,3,7,4,3,0,0,0,4,4,0,1,1,0,1,1,0,51,11,40,0,,33,0,33,28,0,28
9/3/2023 12:00,8,4,4,4,3,1,3,2,1,0,0,0,0,0,0,5,5,0,1,1,0,65,23,42,0,,29,0,29,37,1,36
9/3/2023 13:00,4,1,3,7,4,3,4,4,0,0,0,0,0,0,0,4,4,0,2,2,0,83,44,39,0,,34,0,34,37,0,37
9/3/2023 14:00,8,5,3,2,2,0,7,3,4,0,0,0,0,0,0,5,5,0,1,1,0,74,36,38,0,,48,0,48,32,0,32
9/3/2023 15:00,11,4,7,4,0,4,4,0,4,0,0,0,1,1,0,19,19,0,0,0,0,83,49,34,0,,29,2,27,42,1,41
9/3/2023 16:00,15,6,9,8,3,5,11,4,7,0,0,0,0,0,0,18,18,0,2,2,0,158,96,62,0,,56,0,56,50,0,50
9/3/2023 17:00,26,7,19,14,1,13,17,0,17,0,0,0,0,0,0,20,20,0,1,1,0,215,158,57,0,,122,0,122,49,0,49
9/3/2023 18:00,31,8,23,16,3,13,18,2,16,0,0,0,2,2,0,16,16,0,0,0,0,200,132,68,0,,118,0,118,45,0,45
9/3/2023 19:00,11,6,5,5,0,5,10,1,9,0,0,0,0,0,0,7,7,0,0,0,0,99,68,31,0,,75,0,75,34,1,33
9/3/2023 20:00,10,3,7,1,1,0,5,1,4,0,0,0,0,0,0,1,1,0,0,0,0,87,56,31,0,,54,0,54,37,0,37
9/3/2023 21:00,8,1,7,4,1,3,3,0,3,0,0,0,0,0,0,3,3,0,0,0,0,52,32,20,0,,29,0,29,14,0,14
9/3/2023 22:00,3,3,0,1,0,1,2,0,2,0,0,0,0,0,0,1,1,0,0,0,0,35,21,14,0,,14,0,14,9,0,9
9/3/2023 23:00,2,1,1,1,0,1,1,0,1,0,0,0,2,2,0,1,1,0,0,0,0,18,13,5,0,,12,0,12,2,0,2
10/3/2023 0:00,0,0,0,1,1,0,0,0,0,0,0,0,0,0,0,0,0,0,0,0,0,9,6,3,0,,8,0,8,2,0,2
10/3/2023 1:00,0,0,0,2,1,1,1,0,1,0,0,0,0,0,0,0,0,0,0,0,0,4,1,3,0,,0,0,0,0,0,0
10/3/2023 2:00,0,0,0,0,0,0,0,0,0,0,0,0,0,0,0,0,0,0,0,0,0,3,3,0,0,,2,0,2,1,0,1
10/3/2023 3:00,0,0,0,0,0,0,0,0,0,0,0,0,0,0,0,0,0,0,0,0,0,0,0,0,0,,2,0,2,0,0,0
10/3/2023 4:00,0,0,0,0,0,0,1,1,0,0,0,0,1,1,0,0,0,0,0,0,0,2,0,2,0,,1,0,1,0,0,0
10/3/2023 5:00,2,2,0,1,0,1,2,1,1,0,0,0,0,0,0,0,0,0,0,0,0,12,1,11,0,,3,0,3,6,0,6
10/3/2023 6:00,8,8,0,4,3,1,3,2,1,0,0,0,5,5,0,5,5,0,2,2,0,55,10,45,0,,4,0,4,16,0,16
10/3/2023 7:00,7,5,2,22,16,6,21,16,5,0,0,0,11,11,0,6,6,0,2,2,0,118,26,92,0,,16,0,16,31,0,31
10/3/2023 8:00,20,14,6,39,29,10,41,33,8,0,0,0,15,15,0,25,25,0,29,29,0,211,38,173,0,,25,0,25,80,0,80
10/3/2023 9:00,14,9,5,21,15,6,25,18,7,0,0,0,10,9,1,4,4,0,7,7,0,117,19,98,0,,17,1,16,83,0,83
10/3/2023 10:00,6,5,1,25,12,13,23,11,12,0,0,0,5,5,0,1,1,0,2,2,0,62,26,36,0,,38,1,37,27,0,27
10/3/2023 11:00,8,4,4,29,11,18,27,9,18,0,0,0,9,9,0,4,4,0,3,3,0,61,17,44,0,,42,0,42,56,0,56
10/3/2023 12:00,6,5,1,29,14,15,41,18,23,0,0,0,7,7,0,14,14,0,4,4,0,105,41,64,0,,59,1,58,86,0,86
10/3/2023 13:00,16,9,7,39,18,21,34,20,14,0,0,0,2,2,0,15,15,0,7,7,0,117,48,69,0,,75,1,74,78,1,77
10/3/2023 14:00,16,10,6,34,14,20,38,15,23,0,0,0,6,6,0,12,12,0,10,10,0,86,41,45,0,,50,1,49,54,0,54
10/3/2023 15:00,14,8,6,54,27,27,56,23,33,0,0,0,5,5,0,16,16,0,13,13,0,122,62,60,0,,61,0,61,65,1,64
10/3/2023 16:00,21,6,15,55,24,31,78,33,45,0,0,0,5,5,0,20,20,0,5,5,0,130,79,51,0,,84,0,84,69,0,69
10/3/2023 17:00,27,11,16,71,26,45,103,44,59,0,0,0,4,4,0,15,15,0,12,12,0,208,119,89,0,,116,0,116,90,1,89
10/3/2023 18:00,17,10,7,44,19,25,52,20,32,0,0,0,9,9,0,12,12,0,7,7,0,178,106,72,0,,116,0,116,81,0,81
10/3/2023 19:00,6,3,3,10,4,6,29,10,19,0,0,0,3,3,0,8,8,0,7,7,0,132,70,62,0,,70,1,69,76,1,75
10/3/2023 20:00,4,2,2,4,1,3,14,3,11,0,0,0,3,3,0,6,6,0,3,3,0,91,57,34,0,,69,0,69,58,1,57
10/3/2023 21:00,7,2,5,2,2,0,10,3,7,0,0,0,9,8,1,5,5,0,1,1,0,65,39,26,0,,47,0,47,59,0,59
10/3/2023 22:00,4,4,0,4,2,2,5,0,5,0,0,0,4,4,0,4,4,0,0,0,0,63,31,32,0,,30,0,30,48,0,48
10/3/2023 23:00,5,4,1,3,2,1,2,0,2,0,0,0,0,0,0,2,2,0,0,0,0,34,24,10,0,,32,0,32,24,0,24
11/3/2023 0:00,2,1,1,6,2,4,7,1,6,0,0,0,0,0,0,3,3,0,0,0,0,25,14,11,0,,30,0,30,10,0,10
11/3/2023 1:00,0,0,0,5,3,2,1,1,0,0,0,0,0,0,0,1,1,0,0,0,0,11,8,3,0,,5,0,5,1,0,1
11/3/2023 2:00,1,1,0,2,0,2,4,1,3,0,0,0,1,1,0,0,0,0,0,0,0,9,8,1,0,,10,0,10,1,0,1
11/3/2023 3:00,0,0,0,0,0,0,0,0,0,0,0,0,0,0,0,0,0,0,0,0,0,11,8,3,0,,8,0,8,2,0,2
11/3/2023 4:00,2,0,2,0,0,0,0,0,0,0,0,0,0,0,0,0,0,0,0,0,0,11,9,2,0,,4,1,3,3,0,3
11/3/2023 5:00,1,0,1,0,0,0,0,0,0,0,0,0,0,0,0,0,0,0,1,1,0,11,3,8,0,,2,0,2,2,0,2
11/3/2023 6:00,1,1,0,2,1,1,5,3,2,0,0,0,1,1,0,1,1,0,1,1,0,30,8,22,0,,3,0,3,4,0,4
11/3/2023 7:00,2,2,0,11,3,8,9,0,9,0,0,0,3,3,0,1,1,0,0,0,0,32,11,21,0,,8,0,8,16,0,16
11/3/2023 8:00,3,2,1,26,13,13,29,12,17,0,0,0,5,5,0,6,6,0,1,1,0,41,8,33,0,,5,0,5,22,0,22
11/3/2023 9:00,9,6,3,39,18,21,48,18,30,0,0,0,7,7,0,10,10,0,7,7,0,49,16,33,0,,12,0,12,36,0,36
11/3/2023 10:00,9,6,3,27,16,11,43,22,21,0,0,0,3,3,0,7,7,0,4,4,0,60,15,45,0,,25,0,25,50,0,50
11/3/2023 11:00,3,0,3,24,13,11,26,13,13,0,0,0,0,0,0,2,2,0,2,2,0,41,18,23,0,,36,0,36,29,0,29
11/3/2023 12:00,4,2,2,9,6,3,12,5,7,0,0,0,0,0,0,6,6,0,1,1,0,43,14,29,0,,36,0,36,33,1,32
11/3/2023 13:00,8,3,5,6,3,3,7,3,4,0,0,0,2,2,0,2,2,0,2,2,0,70,31,39,0,,36,1,35,39,0,39
11/3/2023 14:00,1,1,0,4,2,2,5,4,1,0,0,0,2,2,0,6,6,0,1,1,0,65,26,39,0,,37,0,37,39,0,39
11/3/2023 15:00,4,3,1,6,3,3,8,4,4,0,0,0,1,1,0,3,3,0,3,3,0,57,30,27,0,,36,0,36,42,0,42
11/3/2023 16:00,7,6,1,2,0,2,5,1,4,0,0,0,3,3,0,3,3,0,0,0,0,69,40,29,0,,44,0,44,36,2,34
11/3/2023 17:00,4,1,3,8,5,3,9,4,5,0,0,0,2,2,0,4,4,0,3,3,0,45,22,23,0,,56,0,56,55,1,54
11/3/2023 18:00,5,1,4,6,5,1,10,6,4,0,0,0,3,3,0,4,4,0,1,1,0,70,39,31,0,,73,1,72,56,0,56
11/3/2023 19:00,3,1,2,6,4,2,6,1,5,0,0,0,1,1,0,9,9,0,0,0,0,59,23,36,0,,54,0,54,62,1,61
11/3/2023 20:00,4,3,1,3,1,2,4,3,1,0,0,0,4,4,0,4,4,0,0,0,0,57,27,30,0,,42,1,41,50,1,49
11/3/2023 21:00,5,3,2,3,3,0,3,1,2,0,0,0,3,3,0,1,1,0,0,0,0,45,19,26,0,,34,0,34,36,1,35
11/3/2023 22:00,2,2,0,2,1,1,3,1,2,0,0,0,2,2,0,1,1,0,1,1,0,31,15,16,0,,24,1,23,39,0,39
11/3/2023 23:00,3,1,2,1,0,1,3,0,3,0,0,0,1,1,0,1,1,0,1,1,0,24,18,6,0,,20,0,20,23,0,23
12/3/2023 0:00,4,2,2,2,2,0,4,1,3,0,0,0,1,1,0,0,0,0,0,0,0,21,14,7,0,,16,0,16,13,0,13
12/3/2023 1:00,0,0,0,3,3,0,2,2,0,0,0,0,0,0,0,2,2,0,0,0,0,12,8,4,0,,3,0,3,1,0,1
12/3/2023 2:00,0,0,0,0,0,0,1,0,1,0,0,0,0,0,0,0,0,0,1,1,0,12,8,4,0,,4,0,4,3,0,3
12/3/2023 3:00,0,0,0,0,0,0,1,0,1,0,0,0,0,0,0,1,1,0,0,0,0,9,8,1,0,,8,0,8,9,0,9
12/3/2023 4:00,1,0,1,0,0,0,1,0,1,0,0,0,0,0,0,0,0,0,0,0,0,7,4,3,0,,5,0,5,2,0,2
12/3/2023 5:00,0,0,0,2,1,1,2,1,1,0,0,0,0,0,0,0,0,0,0,0,0,7,4,3,0,,2,0,2,4,0,4
12/3/2023 6:00,3,1,2,3,1,2,4,1,3,0,0,0,2,2,0,1,1,0,0,0,0,18,0,18,0,,4,0,4,6,0,6
12/3/2023 7:00,3,2,1,24,14,10,32,12,20,0,0,0,6,6,0,1,1,0,2,2,0,37,13,24,0,,6,0,6,6,0,6
12/3/2023 8:00,4,2,2,81,31,50,98,35,63,0,0,0,8,8,0,4,4,0,5,5,0,40,10,30,0,,7,0,7,19,0,19
12/3/2023 9:00,7,5,2,141,61,80,134,46,88,0,0,0,0,0,0,7,7,0,9,9,0,53,20,33,0,,9,2,7,25,0,25
12/3/2023 10:00,4,4,0,141,53,88,137,61,76,0,0,0,0,0,0,15,15,0,12,12,0,67,22,45,0,,30,0,30,36,0,36
12/3/2023 11:00,5,4,1,160,80,80,201,107,94,0,0,0,0,0,0,28,28,0,13,13,0,78,28,50,0,,39,0,39,51,1,50
12/3/2023 12:00,16,9,7,131,73,58,154,73,81,0,0,0,0,0,0,10,10,0,10,10,0,85,36,49,0,,51,0,51,66,0,66
12/3/2023 13:00,13,8,5,91,46,45,114,65,49,0,0,0,0,0,0,19,19,0,13,13,0,90,43,47,0,,70,1,69,100,0,100
12/3/2023 14:00,10,1,9,66,28,38,76,30,46,0,0,0,1,1,0,17,17,0,13,13,0,94,29,65,0,,61,0,61,64,1,63
12/3/2023 15:00,4,2,2,32,15,17,47,28,19,0,0,0,4,4,0,3,3,0,5,5,0,81,39,42,0,,58,1,57,71,0,71
12/3/2023 16:00,4,2,2,29,18,11,40,15,25,0,0,0,3,3,0,7,7,0,8,8,0,55,37,18,0,,41,0,41,59,0,59
12/3/2023 17:00,9,6,3,24,14,10,23,12,11,0,0,0,0,0,0,7,7,0,1,1,0,78,38,40,0,,71,0,71,68,0,68
12/3/2023 18:00,6,4,2,11,5,6,15,8,7,0,0,0,4,4,0,5,5,0,6,6,0,106,45,61,0,,60,0,60,66,1,65
12/3/2023 19:00,9,6,3,9,5,4,10,4,6,0,0,0,1,1,0,4,4,0,1,1,0,89,49,40,0,,73,0,73,55,0,55
12/3/2023 20:00,6,3,3,4,1,3,8,4,4,0,0,0,2,2,0,7,7,0,2,2,0,62,31,31,0,,56,1,55,53,0,53
12/3/2023 21:00,4,3,1,2,1,1,7,2,5,0,0,0,1,1,0,2,2,0,0,0,0,49,29,20,0,,35,0,35,37,0,37
12/3/2023 22:00,5,5,0,3,2,1,2,1,1,0,0,0,1,1,0,3,3,0,1,1,0,28,20,8,0,,22,0,22,26,2,24
12/3/2023 23:00,4,4,0,1,0,1,3,1,2,0,0,0,0,0,0,0,0,0,0,0,0,12,8,4,0,,17,0,17,14,0,14
13/03/2023 00:00,0,0,0,0,0,0,2,0,2,0,0,0,2,2,0,2,2,0,0,0,0,10,6,4,0,,14,0,14,7,0,7
13/03/2023 01:00,0,0,0,5,4,1,0,0,0,0,0,0,0,0,0,1,1,0,0,0,0,5,4,1,0,,2,0,2,0,0,0
13/03/2023 02:00,1,0,1,0,0,0,0,0,0,0,0,0,0,0,0,0,0,0,0,0,0,9,6,3,0,,4,0,4,3,0,3
13/03/2023 03:00,0,0,0,0,0,0,1,0,1,0,0,0,0,0,0,0,0,0,0,0,0,4,0,4,0,,0,0,0,1,0,1
13/03/2023 04:00,0,0,0,1,1,0,2,0,2,0,0,0,1,1,0,0,0,0,0,0,0,0,0,0,0,,2,0,2,1,0,1
13/03/2023 05:00,1,1,0,3,2,1,5,3,2,0,0,0,2,2,0,1,1,0,0,0,0,25,4,21,0,,2,0,2,8,0,8
13/03/2023 06:00,8,8,0,10,8,2,11,8,3,0,0,0,12,12,0,6,6,0,6,6,0,98,23,75,0,,9,0,9,18,0,18
13/03/2023 07:00,30,23,7,41,34,7,44,36,8,0,0,0,29,29,0,10,10,0,13,13,0,270,59,211,0,,26,0,26,70,0,70
13/03/2023 08:00,79,72,7,57,48,9,78,64,14,0,0,0,47,47,0,40,40,0,105,105,0,498,81,417,0,,57,1,56,179,0,179
13/03/2023 09:00,36,28,8,33,18,15,39,27,12,0,0,0,33,33,0,6,6,0,12,12,0,199,30,169,0,,26,0,26,102,0,102
13/03/2023 10:00,10,7,3,12,4,8,17,4,13,0,0,0,16,16,0,5,5,0,7,7,0,65,19,46,0,,13,1,12,55,0,55
13/03/2023 11:00,8,4,4,26,10,16,25,12,13,0,0,0,9,9,0,8,8,0,4,4,0,51,19,32,0,,28,0,28,45,0,45
13/03/2023 12:00,19,13,6,33,19,14,37,17,20,0,0,0,3,2,1,4,4,0,1,1,0,70,30,40,0,,48,0,48,49,1,48
13/03/2023 13:00,16,6,10,24,9,15,38,16,22,0,0,0,2,2,0,17,17,0,0,0,0,84,40,44,0,,51,0,51,61,0,61
13/03/2023 14:00,9,5,4,13,6,7,22,10,12,0,0,0,2,2,0,6,6,0,0,0,0,60,30,30,0,,50,1,49,25,0,25
13/03/2023 15:00,15,9,6,11,1,10,23,5,18,0,0,0,0,0,0,37,37,0,6,6,0,99,52,47,0,,49,0,49,44,0,44
13/03/2023 16:00,19,5,14,38,10,28,37,5,32,0,0,0,4,4,0,32,32,0,8,8,0,180,108,72,0,,104,0,104,57,0,57
13/03/2023 17:00,44,11,33,60,10,50,80,8,72,0,0,0,12,12,0,28,28,0,12,12,0,343,249,94,0,,187,0,187,85,0,85
13/03/2023 18:00,29,11,18,52,5,47,60,9,51,0,0,0,5,5,0,31,31,0,12,12,0,281,177,104,0,,193,1,192,82,1,81
13/03/2023 19:00,15,7,8,27,12,15,38,14,24,0,0,0,3,3,0,16,16,0,15,15,0,160,107,53,0,,99,0,99,76,0,76
13/03/2023 20:00,12,4,8,14,6,8,25,16,9,0,0,0,3,3,0,4,4,0,3,3,0,109,67,42,0,,61,0,61,48,0,48
13/03/2023 21:00,11,4,7,8,2,6,16,2,14,0,0,0,3,2,1,9,9,0,2,2,0,75,48,27,0,,46,0,46,54,1,53
13/03/2023 22:00,4,1,3,3,2,1,8,1,7,0,0,0,0,0,0,7,7,0,0,0,0,36,19,17,0,,31,0,31,23,0,23
13/03/2023 23:00,1,1,0,2,0,2,1,1,0,0,0,0,1,1,0,1,1,0,0,0,0,24,13,11,0,,16,0,16,11,0,11
14/03/2023 00:00,1,1,0,0,0,0,1,0,1,0,0,0,0,0,0,0,0,0,0,0,0,9,5,4,0,,13,0,13,9,0,9
14/03/2023 01:00,1,0,1,2,2,0,2,2,0,0,0,0,1,1,0,1,1,0,0,0,0,3,2,1,0,,3,1,2,1,0,1
14/03/2023 02:00,0,0,0,0,0,0,1,0,1,0,0,0,0,0,0,0,0,0,0,0,0,2,1,1,0,,2,0,2,1,0,1
14/03/2023 03:00,0,0,0,0,0,0,0,0,0,0,0,0,0,0,0,0,0,0,0,0,0,2,1,1,0,,3,0,3,0,0,0
14/03/2023 04:00,1,1,0,2,2,0,4,1,3,0,0,0,2,2,0,0,0,0,0,0,0,3,2,1,0,,2,0,2,4,0,4
14/03/2023 05:00,2,2,0,2,1,1,5,2,3,0,0,0,1,1,0,1,1,0,0,0,0,31,4,27,0,,3,0,3,6,0,6
14/03/2023 06:00,7,6,1,15,12,3,22,18,4,0,0,0,14,14,0,4,4,0,1,1,0,107,23,84,0,,8,0,8,20,0,20
14/03/2023 07:00,46,40,6,59,50,9,81,69,12,0,0,0,44,42,2,11,11,0,0,0,0,331,69,262,0,,43,0,43,98,2,96
14/03/2023 08:00,98,88,10,83,67,16,103,86,17,0,0,0,67,67,0,45,45,0,2,2,0,673,91,582,0,,54,0,54,241,0,241
14/03/2023 09:00,45,35,10,50,28,22,62,36,26,0,0,0,43,42,1,17,17,0,2,2,0,272,46,226,0,,24,0,24,145,0,145
14/03/2023 10:00,19,12,7,45,18,27,47,17,30,0,0,0,9,9,0,5,5,0,5,5,0,81,17,64,0,,22,0,22,61,1,60
14/03/2023 11:00,25,12,13,48,28,20,60,29,31,0,0,0,10,10,0,6,6,0,6,6,0,59,19,40,0,,29,1,28,50,0,50
14/03/2023 12:00,17,11,6,41,22,19,78,35,43,0,0,0,4,4,0,11,11,0,1,1,0,87,35,52,0,,48,0,48,58,0,58
14/03/2023 13:00,13,3,10,21,7,14,34,11,23,0,0,0,1,1,0,15,15,0,3,3,0,87,40,47,0,,39,1,38,63,0,63
14/03/2023 14:00,5,3,2,21,5,16,24,7,17,0,0,0,1,1,0,12,12,0,7,7,0,101,49,52,0,,43,0,43,54,0,54
14/03/2023 15:00,13,7,6,24,10,14,26,10,16,0,0,0,5,5,0,38,38,0,4,4,0,124,71,53,0,,75,0,75,51,0,51
14/03/2023 16:00,24,6,18,44,14,30,61,19,42,0,0,0,3,3,0,32,32,0,12,12,0,196,122,74,0,,126,1,125,59,0,59
14/03/2023 17:00,58,10,48,101,22,79,131,27,104,0,0,0,0,0,0,36,36,0,5,5,0,422,298,124,0,,236,0,236,95,1,94
14/03/2023 18:00,51,15,36,83,24,59,127,27,100,0,0,0,5,4,1,35,35,0,0,0,0,320,222,98,0,,169,1,168,116,1,115
14/03/2023 19:00,21,8,13,50,20,30,52,18,34,0,0,0,7,7,0,19,19,0,0,0,0,177,116,61,0,,97,0,97,88,0,88
14/03/2023 20:00,13,2,11,42,16,26,59,18,41,0,0,0,1,1,0,16,16,0,0,0,0,128,90,38,0,,92,1,91,66,0,66
14/03/2023 21:00,8,1,7,28,14,14,28,12,16,0,0,0,2,1,1,13,13,0,0,0,0,79,61,18,0,,43,0,43,52,0,52
14/03/2023 22:00,3,2,1,7,1,6,10,3,7,0,0,0,1,1,0,3,3,0,0,0,0,52,37,15,0,,42,0,42,31,0,31
14/03/2023 23:00,1,1,0,1,0,1,4,1,3,0,0,0,2,2,0,2,2,0,0,0,0,29,23,6,0,,23,0,23,23,1,22
15/03/2023 00:00,0,0,0,0,0,0,0,0,0,0,0,0,1,0,1,0,0,0,0,0,0,17,9,8,0,,26,0,26,6,0,6
15/03/2023 01:00,2,0,2,2,2,0,1,1,0,0,0,0,0,0,0,0,0,0,0,0,0,5,4,1,0,,7,0,7,0,0,0
15/03/2023 02:00,0,0,0,0,0,0,1,1,0,0,0,0,0,0,0,0,0,0,0,0,0,4,3,1,0,,4,1,3,2,0,2
15/03/2023 03:00,0,0,0,0,0,0,0,0,0,0,0,0,0,0,0,0,0,0,0,0,0,3,2,1,0,,2,0,2,0,0,0
15/03/2023 04:00,0,0,0,1,1,0,2,1,1,0,0,0,0,0,0,0,0,0,0,0,0,1,0,1,0,,1,0,1,1,1,0
15/03/2023 05:00,2,2,0,3,2,1,5,3,2,0,0,0,3,3,0,1,1,0,1,1,0,24,5,19,0,,3,0,3,13,0,13
15/03/2023 06:00,9,9,0,19,14,5,30,22,8,0,0,0,11,10,1,4,4,0,6,6,0,112,25,87,0,,7,0,7,23,0,23
15/03/2023 07:00,46,34,12,43,36,7,49,44,5,0,0,0,25,25,0,13,13,0,10,10,0,297,53,244,0,,31,1,30,85,0,85
15/03/2023 08:00,86,75,11,70,54,16,82,71,11,0,0,0,27,27,0,36,36,0,63,63,0,565,80,485,0,,53,0,53,173,0,173
15/03/2023 09:00,29,26,3,15,10,5,23,16,7,0,0,0,23,23,0,8,8,0,3,3,0,199,30,169,0,,26,0,26,113,1,112
15/03/2023 10:00,6,5,1,10,6,4,14,5,9,0,0,0,8,8,0,9,9,0,3,3,0,62,19,43,0,,27,0,27,36,0,36
15/03/2023 11:00,8,6,2,10,6,4,15,7,8,0,0,0,1,1,0,7,7,0,5,5,0,63,20,43,0,,21,0,21,43,1,42
15/03/2023 12:00,15,7,8,4,1,3,11,5,6,0,0,0,0,0,0,8,8,0,3,3,0,77,36,41,0,,40,0,40,62,0,62
15/03/2023 13:00,18,8,10,10,3,7,15,4,11,0,0,0,7,7,0,13,13,0,5,5,0,103,46,57,0,,46,0,46,55,2,53
15/03/2023 14:00,10,3,7,12,4,8,13,5,8,0,0,0,7,7,0,9,9,0,8,8,0,96,47,49,0,,72,2,70,55,0,55
15/03/2023 15:00,20,7,13,13,1,12,23,4,19,0,0,0,8,8,0,32,32,0,13,13,0,126,66,60,0,,69,0,69,48,1,47
15/03/2023 16:00,20,10,10,16,3,13,30,7,23,0,0,0,0,0,0,27,27,0,0,0,0,194,129,65,0,,85,0,85,53,0,53
15/03/2023 17:00,44,15,29,45,6,39,59,6,53,0,0,0,0,0,0,22,22,0,0,0,0,350,247,103,0,,196,0,196,67,1,66
15/03/2023 18:00,37,11,26,33,5,28,66,5,61,0,0,0,2,2,0,24,24,0,1,1,0,313,206,107,0,,159,0,159,72,2,70
15/03/2023 19:00,21,5,16,25,4,21,37,11,26,0,0,0,3,3,0,7,7,0,2,2,0,157,102,55,0,,111,0,111,60,0,60
15/03/2023 20:00,6,1,5,11,6,5,18,9,9,0,0,0,4,4,0,5,5,0,0,0,0,125,80,45,0,,77,1,76,57,0,57
15/03/2023 21:00,3,2,1,10,6,4,10,3,7,0,0,0,2,2,0,9,9,0,2,2,0,87,57,30,0,,68,1,67,62,1,61
15/03/2023 22:00,5,2,3,2,0,2,6,1,5,0,0,0,4,4,0,6,6,0,0,0,0,56,40,16,0,,39,0,39,33,0,33
15/03/2023 23:00,6,6,0,4,1,3,4,2,2,0,0,0,1,1,0,2,2,0,0,0,0,23,16,7,0,,22,0,22,11,1,10
16/03/2023 00:00,0,0,0,0,0,0,1,0,1,0,0,0,0,0,0,0,0,0,0,0,0,17,13,4,0,,10,0,10,7,0,7
16/03/2023 01:00,1,0,1,5,3,2,4,1,3,0,0,0,1,1,0,0,0,0,0,0,0,3,3,0,0,,4,0,4,2,0,2
16/03/2023 02:00,1,0,1,1,0,1,0,0,0,0,0,0,0,0,0,0,0,0,0,0,0,4,3,1,0,,4,0,4,2,0,2
16/03/2023 03:00,0,0,0,0,0,0,0,0,0,0,0,0,0,0,0,0,0,0,0,0,0,3,2,1,0,,4,0,4,1,0,1
16/03/2023 04:00,1,1,0,1,1,0,1,1,0,0,0,0,2,2,0,0,0,0,0,0,0,4,1,3,0,,3,0,3,1,1,0
16/03/2023 05:00,1,1,0,4,3,1,7,4,3,0,0,0,5,5,0,2,2,0,0,0,0,31,4,27,0,,4,0,4,8,0,8
16/03/2023 06:00,6,4,2,14,12,2,22,19,3,0,0,0,10,9,1,5,5,0,0,0,0,102,27,75,0,,8,0,8,26,0,26
16/03/2023 07:00,33,26,7,28,23,5,34,29,5,0,0,0,39,39,0,5,5,0,3,3,0,223,44,179,0,,23,1,22,61,0,61
16/03/2023 08:00,86,76,10,67,50,17,81,62,19,0,0,0,62,62,0,38,38,0,49,49,0,486,84,402,0,,50,0,50,173,1,172
16/03/2023 09:00,37,31,6,40,24,16,50,33,17,0,0,0,40,40,0,13,13,0,17,17,0,198,28,170,0,,39,0,39,138,0,138
16/03/2023 10:00,13,12,1,36,12,24,39,14,25,0,0,0,20,20,0,10,10,0,11,11,0,80,17,63,0,,36,0,36,74,0,74
16/03/2023 11:00,14,9,5,47,23,24,51,20,31,0,0,0,14,14,0,10,10,0,2,2,0,81,21,60,0,,34,0,34,67,0,67
16/03/2023 12:00,19,10,9,34,14,20,49,24,25,0,0,0,14,14,0,9,9,0,2,2,0,107,42,65,0,,68,1,67,96,1,95
16/03/2023 13:00,9,6,3,49,24,25,61,31,30,0,0,0,6,6,0,15,15,0,1,1,0,120,50,70,0,,79,0,79,95,1,94
16/03/2023 14:00,24,12,12,41,21,20,45,15,30,0,0,0,4,4,0,11,11,0,2,2,0,112,41,71,0,,88,0,88,74,1,73
16/03/2023 15:00,16,5,11,49,20,29,55,21,34,0,0,0,8,8,0,28,28,0,8,8,0,139,73,66,0,,54,0,54,75,2,73
16/03/2023 16:00,30,7,23,53,24,29,70,18,52,0,0,0,12,12,0,35,35,0,13,13,0,210,130,80,0,,101,0,101,85,0,85
16/03/2023 17:00,39,12,27,94,35,59,122,36,86,0,0,0,10,10,0,27,27,0,4,4,0,319,206,113,0,,184,1,183,109,1,108
16/03/2023 18:00,31,11,20,94,37,57,112,35,77,0,0,0,18,18,0,25,25,0,3,3,0,240,143,97,0,,169,0,169,118,1,117
16/03/2023 19:00,16,7,9,36,13,23,49,25,24,0,0,0,12,12,0,13,13,0,2,2,0,171,94,77,0,,94,0,94,80,0,80
16/03/2023 20:00,8,0,8,24,11,13,35,12,23,0,0,0,9,9,0,9,9,0,1,1,0,113,72,41,0,,52,0,52,83,0,83
16/03/2023 21:00,13,6,7,14,8,6,17,6,11,0,0,0,5,5,0,9,9,0,0,0,0,92,62,30,0,,46,0,46,56,1,55
16/03/2023 22:00,4,3,1,5,2,3,10,5,5,0,0,0,2,2,0,8,8,0,2,2,0,67,43,24,0,,39,0,39,33,0,33
16/03/2023 23:00,3,3,0,5,2,3,1,0,1,0,0,0,7,7,0,3,3,0,3,3,0,47,29,18,0,,33,1,32,32,0,32
17/03/2023 00:00,2,1,1,5,2,3,12,4,8,0,0,0,3,3,0,3,3,0,0,0,0,28,19,9,0,,26,0,26,20,1,19
17/03/2023 01:00,0,0,0,0,0,0,0,0,0,0,0,0,1,1,0,1,1,0,0,0,0,18,14,4,0,,9,0,9,0,0,0
17/03/2023 02:00,1,1,0,0,0,0,1,0,1,0,0,0,1,1,0,0,0,0,0,0,0,10,8,2,0,,16,0,16,4,0,4
17/03/2023 03:00,0,0,0,0,0,0,1,0,1,0,0,0,2,2,0,0,0,0,0,0,0,12,9,3,0,,19,0,19,5,0,5
17/03/2023 04:00,1,0,1,0,0,0,1,0,1,0,0,0,0,0,0,0,0,0,0,0,0,6,3,3,0,,4,0,4,2,0,2
17/03/2023 05:00,0,0,0,1,0,1,1,0,1,0,0,0,0,0,0,0,0,0,0,0,0,10,2,8,0,,3,0,3,2,0,2
17/03/2023 06:00,2,2,0,7,3,4,8,3,5,0,0,0,5,5,0,1,1,0,0,0,0,31,6,25,0,,7,0,7,14,0,14
17/03/2023 07:00,3,3,0,27,10,17,28,10,18,0,0,0,14,13,1,1,1,0,3,3,0,52,14,38,0,,13,0,13,17,1,16
17/03/2023 08:00,9,8,1,74,37,37,73,28,45,0,0,0,13,13,0,5,5,0,4,4,0,48,15,33,0,,17,0,17,29,0,29
17/03/2023 09:00,9,7,2,94,45,49,92,41,51,0,0,0,12,12,0,3,3,0,0,0,0,60,15,45,0,,19,0,19,46,0,46
17/03/2023 10:00,10,7,3,77,39,38,79,38,41,0,0,0,6,6,0,8,8,0,2,2,0,86,28,58,0,,36,0,36,26,0,26
17/03/2023 11:00,17,10,7,74,46,28,96,57,39,0,0,0,3,3,0,13,13,0,2,2,0,93,32,61,0,,31,0,31,69,0,69
17/03/2023 12:00,13,6,7,52,27,25,59,28,31,0,0,0,3,3,0,5,5,0,1,1,0,88,38,50,0,,35,1,34,86,0,86
17/03/2023 13:00,9,6,3,47,19,28,52,18,34,0,0,0,5,5,0,12,12,0,3,3,0,81,31,50,0,,43,0,43,73,1,72
17/03/2023 14:00,6,4,2,53,28,25,66,34,32,0,0,0,5,5,0,6,6,0,1,1,0,88,32,56,0,,51,0,51,63,2,61
17/03/2023 15:00,10,7,3,39,15,24,46,19,27,0,0,0,5,5,0,10,10,0,2,2,0,96,43,53,0,,57,0,57,41,0,41
17/03/2023 16:00,6,3,3,42,23,19,58,30,28,0,0,0,5,5,0,9,9,0,0,0,0,78,28,50,0,,38,0,38,41,0,41
17/03/2023 17:00,8,4,4,32,20,12,53,22,31,0,0,0,9,8,1,12,12,0,0,0,0,91,36,55,0,,37,0,37,78,0,78
17/03/2023 18:00,4,4,0,17,8,9,23,9,14,0,0,0,6,6,0,9,9,0,0,0,0,73,40,33,0,,42,0,42,51,2,49
17/03/2023 19:00,7,2,5,5,2,3,16,8,8,0,0,0,5,5,0,6,6,0,0,0,0,65,25,40,0,,36,0,36,71,0,71
17/03/2023 20:00,3,2,1,8,3,5,9,4,5,0,0,0,12,11,1,3,3,0,0,0,0,49,28,21,0,,25,0,25,54,1,53
17/03/2023 21:00,4,1,3,2,2,0,2,1,1,0,0,0,9,9,0,3,3,0,0,0,0,42,20,22,0,,16,0,16,29,0,29
17/03/2023 22:00,4,3,1,3,1,2,7,0,7,0,0,0,5,4,1,4,4,0,0,0,0,61,42,19,0,,28,0,28,30,0,30
17/03/2023 23:00,4,1,3,2,2,0,3,1,2,0,0,0,2,2,0,2,2,0,0,0,0,26,20,6,0,,23,0,23,29,0,29
18/03/2023 00:00,0,0,0,2,1,1,5,2,3,0,0,0,0,0,0,2,2,0,0,0,0,16,11,5,0,,4,0,4,20,0,20
18/03/2023 01:00,2,1,1,3,2,1,4,1,3,0,0,0,3,3,0,2,2,0,0,0,0,22,11,11,0,,3,0,3,1,0,1
18/03/2023 02:00,2,2,0,0,0,0,0,0,0,0,0,0,2,2,0,0,0,0,0,0,0,20,14,6,0,,8,0,8,2,0,2
18/03/2023 03:00,0,0,0,0,0,0,0,0,0,0,0,0,2,2,0,0,0,0,0,0,0,18,12,6,0,,17,1,16,4,1,3
18/03/2023 04:00,1,0,1,1,0,1,2,1,1,0,0,0,0,0,0,1,1,0,0,0,0,6,3,3,0,,4,0,4,3,0,3
18/03/2023 05:00,1,1,0,2,2,0,3,3,0,0,0,0,1,1,0,1,1,0,0,0,0,9,5,4,0,,7,0,7,6,0,6
18/03/2023 06:00,1,1,0,5,2,3,8,3,5,0,0,0,3,3,0,1,1,0,0,0,0,30,6,24,0,,3,0,3,6,0,6
18/03/2023 07:00,5,3,2,32,14,18,26,11,15,0,0,0,7,7,0,2,2,0,1,1,0,40,14,26,0,,6,0,6,12,0,12
18/03/2023 08:00,6,5,1,64,23,41,78,30,48,0,0,0,10,10,0,6,6,0,0,0,0,45,11,34,0,,12,0,12,22,0,22
18/03/2023 09:00,6,4,2,103,40,63,113,46,67,0,0,0,12,12,0,9,9,0,6,6,0,58,18,40,0,,21,0,21,42,0,42
18/03/2023 10:00,6,6,0,105,49,56,118,48,70,0,0,0,9,9,0,16,16,0,16,16,0,58,15,43,0,,32,0,32,58,0,58
18/03/2023 11:00,12,8,4,115,64,51,111,55,56,0,0,0,1,1,0,15,15,0,3,3,0,77,30,47,0,,55,1,54,63,0,63
18/03/2023 12:00,12,2,10,60,42,18,64,41,23,0,0,0,1,1,0,8,8,0,0,0,0,69,25,44,0,,51,0,51,51,0,51
18/03/2023 13:00,6,4,2,20,8,12,27,17,10,0,0,0,6,6,0,5,5,0,0,0,0,70,31,39,0,,31,0,31,53,1,52
18/03/2023 14:00,9,8,1,25,10,15,33,15,18,0,0,0,5,5,0,6,6,0,0,0,0,101,56,45,0,,47,0,47,66,1,65
18/03/2023 15:00,16,10,6,33,19,14,53,24,29,0,0,0,12,11,1,8,8,0,0,0,0,104,38,66,0,,49,0,49,60,0,60
18/03/2023 16:00,15,7,8,25,14,11,32,21,11,0,0,0,11,11,0,6,6,0,1,1,0,100,35,65,0,,57,0,57,60,0,60
18/03/2023 17:00,3,1,2,30,14,16,29,11,18,0,0,0,8,8,0,5,5,0,0,0,0,66,33,33,0,,54,0,54,51,1,50
18/03/2023 18:00,9,4,5,16,7,9,28,16,12,0,0,0,6,6,0,9,9,0,0,0,0,80,39,41,0,,58,0,58,69,0,69
18/03/2023 19:00,5,4,1,14,7,7,18,5,13,0,0,0,10,10,0,8,8,0,0,0,0,105,56,49,0,,47,0,47,76,0,76
18/03/2023 20:00,14,6,8,9,5,4,18,8,10,0,0,0,9,9,0,5,5,0,1,1,0,104,43,61,0,,43,0,43,55,0,55
18/03/2023 21:00,7,6,1,3,3,0,2,2,0,0,0,0,3,3,0,2,2,0,0,0,0,87,42,45,0,,34,0,34,37,0,37
18/03/2023 22:00,5,1,4,2,2,0,2,1,1,0,0,0,7,7,0,3,3,0,1,1,0,89,41,48,0,,27,1,26,33,0,33
18/03/2023 23:00,8,4,4,1,0,1,3,0,3,0,0,0,3,3,0,1,1,0,0,0,0,39,25,14,0,,24,0,24,26,0,26
19/03/2023 00:00,2,0,2,2,1,1,3,1,2,0,0,0,2,2,0,2,2,0,0,0,0,29,22,7,0,,11,0,11,7,0,7
19/03/2023 01:00,1,1,0,0,0,0,0,0,0,0,0,0,0,0,0,1,1,0,0,0,0,21,17,4,0,,3,0,3,1,0,1
19/03/2023 02:00,0,0,0,0,0,0,0,0,0,0,0,0,0,0,0,0,0,0,0,0,0,13,10,3,0,,7,1,6,3,0,3
19/03/2023 03:00,0,0,0,0,0,0,2,0,2,0,0,0,0,0,0,0,0,0,0,0,0,11,6,5,0,,12,0,12,1,0,1
19/03/2023 04:00,2,0,2,0,0,0,0,0,0,0,0,0,0,0,0,0,0,0,0,0,0,7,5,2,0,,5,0,5,4,0,4
19/03/2023 05:00,0,0,0,2,1,1,3,2,1,0,0,0,0,0,0,0,0,0,0,0,0,9,6,3,0,,4,0,4,3,0,3
19/03/2023 06:00,1,1,0,1,1,0,1,1,0,0,0,0,0,0,0,0,0,0,0,0,0,20,2,18,0,,6,1,5,2,0,2
19/03/2023 07:00,2,1,1,17,6,11,15,5,10,0,0,0,14,14,0,1,1,0,0,0,0,39,10,29,0,,10,0,10,10,0,10
19/03/2023 08:00,3,2,1,85,30,55,116,46,70,0,0,0,7,7,0,1,1,0,6,6,0,38,15,23,0,,7,0,7,21,0,21
19/03/2023 09:00,8,6,2,110,46,64,113,51,62,0,0,0,6,6,0,2,2,0,8,8,0,47,15,32,0,,10,0,10,27,0,27
19/03/2023 10:00,8,3,5,147,76,71,167,79,88,0,0,0,3,3,0,11,11,0,5,5,0,79,15,64,0,,27,0,27,57,0,57
19/03/2023 11:00,8,4,4,150,64,86,174,81,93,0,0,0,2,2,0,15,15,0,4,4,0,81,23,58,0,,37,0,37,62,0,62
19/03/2023 12:00,11,8,3,121,69,52,129,69,60,0,0,0,7,7,0,8,8,0,2,2,0,106,48,58,0,,46,0,46,61,0,61
19/03/2023 13:00,12,6,6,86,47,39,109,51,58,0,0,0,6,6,0,15,15,0,1,1,0,103,44,59,0,,44,0,44,72,0,72
19/03/2023 14:00,16,5,11,65,37,28,75,38,37,0,0,0,4,4,0,12,12,0,0,0,0,67,40,27,0,,54,0,54,54,0,54
19/03/2023 15:00,5,3,2,29,18,11,45,31,14,0,0,0,3,3,0,8,8,0,0,0,0,52,22,30,0,,42,0,42,39,0,39
19/03/2023 16:00,7,1,6,15,9,6,18,10,8,0,0,0,1,1,0,5,5,0,0,0,0,47,26,21,0,,36,0,36,25,1,24
19/03/2023 17:00,7,5,2,7,2,5,11,8,3,0,0,0,1,1,0,1,1,0,0,0,0,54,26,28,0,,42,1,41,42,0,42
19/03/2023 18:00,10,5,5,5,4,1,8,4,4,0,0,0,3,3,0,4,4,0,0,0,0,76,39,37,0,,53,0,53,62,0,62
19/03/2023 19:00,5,2,3,5,1,4,13,2,11,0,0,0,3,3,0,6,6,0,0,0,0,69,37,32,0,,41,0,41,50,0,50
19/03/2023 20:00,2,0,2,8,4,4,13,5,8,0,0,0,0,0,0,7,7,0,0,0,0,70,45,25,0,,24,0,24,30,0,30
19/03/2023 21:00,5,3,2,3,2,1,7,3,4,0,0,0,5,5,0,4,4,0,1,1,0,48,23,25,0,,26,1,25,27,0,27
19/03/2023 22:00,6,5,1,2,2,0,5,3,2,0,0,0,4,4,0,3,3,0,0,0,0,31,20,11,0,,24,0,24,26,0,26
19/03/2023 23:00,3,3,0,3,2,1,5,1,4,0,0,0,1,1,0,0,0,0,0,0,0,13,9,4,0,,13,0,13,13,0,13
20/03/2023 00:00,0,0,0,1,1,0,1,0,1,0,0,0,0,0,0,1,1,0,0,0,0,12,9,3,0,,9,0,9,11,0,11
20/03/2023 01:00,3,2,1,3,2,1,3,2,1,0,0,0,0,0,0,2,2,0,0,0,0,8,7,1,0,,2,0,2,0,0,0
20/03/2023 02:00,1,0,1,0,0,0,0,0,0,0,0,0,0,0,0,0,0,0,0,0,0,5,4,1,0,,5,0,5,1,0,1
20/03/2023 03:00,0,0,0,1,0,1,0,0,0,0,0,0,0,0,0,0,0,0,0,0,0,1,0,1,0,,0,0,0,0,0,0
20/03/2023 04:00,0,0,0,1,1,0,1,0,1,0,0,0,1,1,0,0,0,0,1,1,0,2,0,2,0,,1,0,1,2,0,2
20/03/2023 05:00,0,0,0,5,4,1,8,5,3,0,0,0,1,1,0,1,1,0,0,0,0,25,4,21,0,,4,0,4,3,0,3
20/03/2023 06:00,7,7,0,13,9,4,17,13,4,0,0,0,10,10,0,6,6,0,0,0,0,88,24,64,0,,8,0,8,18,0,18
20/03/2023 07:00,33,29,4,45,42,3,58,51,7,0,0,0,40,39,1,10,10,0,0,0,0,255,63,192,0,,22,0,22,66,0,66
20/03/2023 08:00,79,69,10,74,57,17,90,72,18,0,0,0,69,69,0,36,36,0,12,12,0,452,76,376,0,,46,1,45,158,2,156
20/03/2023 09:00,32,23,9,33,17,16,59,32,27,0,0,0,25,25,0,10,10,0,5,5,0,180,39,141,0,,33,0,33,145,0,145
20/03/2023 10:00,17,11,6,46,18,28,48,16,32,0,0,0,9,8,1,11,11,0,2,2,0,70,17,53,0,,27,0,27,61,1,60
20/03/2023 11:00,9,5,4,44,19,25,49,23,26,0,0,0,7,7,0,7,7,0,1,1,0,68,21,47,0,,40,0,40,68,1,67
20/03/2023 12:00,23,11,12,51,21,30,60,27,33,0,0,0,5,5,0,13,13,0,0,0,0,94,41,53,0,,60,0,60,61,0,61
20/03/2023 13:00,11,6,5,48,18,30,53,24,29,0,0,0,4,4,0,9,9,0,0,0,0,106,46,60,0,,83,0,83,67,0,67
20/03/2023 14:00,18,4,14,36,19,17,42,18,24,0,0,0,6,6,0,17,17,0,0,0,0,97,46,51,0,,74,2,72,54,1,53
20/03/2023 15:00,22,10,12,46,23,23,54,26,28,0,0,0,2,2,0,37,37,0,0,0,0,145,85,60,0,,76,0,76,59,0,59
20/03/2023 16:00,20,10,10,46,12,34,63,21,42,0,0,0,4,4,0,33,33,0,3,3,0,195,116,79,0,,127,1,126,78,0,78
20/03/2023 17:00,38,15,23,69,15,54,107,22,85,0,0,0,6,5,1,40,40,0,1,1,0,345,232,113,0,,234,0,234,77,0,77
20/03/2023 18:00,31,11,20,69,18,51,82,14,68,0,0,0,9,9,0,30,30,0,0,0,0,280,191,89,0,,171,0,171,84,1,83
20/03/2023 19:00,20,5,15,36,13,23,48,23,25,0,0,0,5,5,0,16,16,0,0,0,0,160,106,54,0,,138,0,138,70,2,68
20/03/2023 20:00,11,5,6,16,8,8,22,14,8,0,0,0,7,7,0,17,17,0,2,2,0,122,67,55,0,,71,0,71,53,0,53
20/03/2023 21:00,6,4,2,7,2,5,9,1,8,0,0,0,8,8,0,8,8,0,0,0,0,68,44,24,0,,60,0,60,29,0,29
20/03/2023 22:00,6,2,4,3,1,2,9,2,7,0,0,0,6,6,0,4,4,0,0,0,0,58,34,24,0,,44,1,43,32,0,32
20/03/2023 23:00,2,1,1,3,1,2,3,1,2,0,0,0,3,3,0,2,2,0,0,0,0,13,8,5,0,,23,0,23,9,0,9
21/03/2023 00:00,0,0,0,0,0,0,0,0,0,0,0,0,2,2,0,0,0,0,0,0,0,14,10,4,0,,15,0,15,6,0,6
21/03/2023 01:00,0,0,0,2,2,0,2,2,0,0,0,0,1,1,0,0,0,0,0,0,0,3,3,0,0,,2,0,2,0,0,0
21/03/2023 02:00,0,0,0,0,0,0,2,0,2,0,0,0,0,0,0,0,0,0,0,0,0,3,3,0,0,,4,0,4,3,0,3
21/03/2023 03:00,0,0,0,1,1,0,0,0,0,0,0,0,0,0,0,0,0,0,0,0,0,2,1,1,0,,1,0,1,0,0,0
21/03/2023 04:00,2,2,0,0,0,0,1,0,1,0,0,0,1,1,0,0,0,0,0,0,0,4,1,3,0,,4,0,4,1,0,1
21/03/2023 05:00,1,1,0,3,2,1,5,3,2,0,0,0,4,4,0,2,2,0,0,0,0,27,2,25,0,,2,0,2,7,0,7
21/03/2023 06:00,14,11,3,22,15,7,22,18,4,0,0,0,13,13,0,7,7,0,0,0,0,110,23,87,0,,9,0,9,35,0,35
21/03/2023 07:00,59,49,10,62,50,12,78,62,16,0,0,0,31,31,0,10,10,0,1,1,0,348,70,278,0,,33,0,33,94,2,92
21/03/2023 08:00,111,99,12,90,70,20,114,89,25,0,0,0,100,100,0,50,50,0,91,91,0,617,100,517,0,,39,0,39,244,0,244
21/03/2023 09:00,39,34,5,63,33,30,69,44,25,0,0,0,50,50,0,12,12,0,15,15,0,245,36,209,0,,29,1,28,158,0,158
21/03/2023 10:00,8,6,2,36,17,19,51,19,32,0,0,0,11,11,0,14,14,0,4,4,0,99,34,65,0,,33,0,33,63,1,62
21/03/2023 11:00,12,9,3,59,29,30,65,33,32,0,0,0,12,12,0,6,6,0,1,1,0,80,28,52,0,,29,0,29,70,0,70
21/03/2023 12:00,13,11,2,50,23,27,61,24,37,0,0,0,6,6,0,8,8,0,5,5,0,88,32,56,0,,67,0,67,72,0,72
21/03/2023 13:00,18,8,10,26,11,15,43,18,25,0,0,0,6,6,0,25,25,0,8,8,0,116,53,63,0,,76,0,76,70,0,70
21/03/2023 14:00,11,3,8,29,16,13,33,12,21,0,0,0,5,5,0,16,16,0,6,6,0,84,50,34,0,,75,0,75,63,0,63
21/03/2023 15:00,14,10,4,24,7,17,40,11,29,0,0,0,3,3,0,50,50,0,17,17,0,143,75,68,0,,88,0,88,67,0,67
21/03/2023 16:00,34,8,26,29,6,23,34,8,26,0,0,0,1,1,0,33,33,0,14,14,0,206,141,65,0,,124,1,123,58,0,58
21/03/2023 17:00,74,16,58,62,8,54,93,10,83,0,0,0,12,12,0,34,34,0,10,10,0,374,270,104,0,,243,1,242,61,0,61
21/03/2023 18:00,40,13,27,59,9,50,90,11,79,0,0,0,5,5,0,28,28,0,2,2,0,339,248,91,0,,208,0,208,80,0,80
21/03/2023 19:00,20,6,14,20,2,18,22,2,20,0,0,0,0,0,0,22,22,0,0,0,0,158,110,48,0,,113,0,113,62,0,62
21/03/2023 20:00,12,7,5,13,4,9,18,4,14,0,0,0,0,0,0,16,16,0,6,6,0,114,67,47,0,,75,0,75,54,0,54
21/03/2023 21:00,7,4,3,5,1,4,10,2,8,0,0,0,0,0,0,8,8,0,0,0,0,81,54,27,0,,48,0,48,40,0,40
21/03/2023 22:00,9,6,3,6,3,3,8,1,7,0,0,0,0,0,0,3,3,0,0,0,0,47,33,14,0,,30,0,30,28,1,27
21/03/2023 23:00,2,2,0,1,0,1,1,0,1,0,0,0,3,3,0,1,1,0,0,0,0,24,17,7,0,,26,0,26,11,0,11
22/03/2023 00:00,0,0,0,0,0,0,1,0,1,0,0,0,1,1,0,3,3,0,0,0,0,15,13,2,0,,13,0,13,4,0,4
22/03/2023 01:00,1,1,0,2,2,0,2,2,0,0,0,0,1,1,0,0,0,0,0,0,0,3,3,0,0,,3,0,3,0,0,0
22/03/2023 02:00,1,0,1,0,0,0,0,0,0,0,0,0,0,0,0,0,0,0,0,0,0,2,2,0,0,,3,0,3,2,0,2
22/03/2023 03:00,0,0,0,0,0,0,1,0,1,0,0,0,1,1,0,0,0,0,0,0,0,2,1,1,0,,1,0,1,0,0,0
22/03/2023 04:00,1,1,0,2,2,0,1,0,1,0,0,0,1,1,0,0,0,0,1,1,0,4,1,3,0,,0,0,0,1,0,1
22/03/2023 05:00,2,1,1,9,5,4,9,4,5,0,0,0,2,2,0,3,3,0,0,0,0,23,1,22,0,,4,0,4,11,0,11
22/03/2023 06:00,11,11,0,16,12,4,21,14,7,0,0,0,16,16,0,9,9,0,9,9,0,115,22,93,0,,9,0,9,30,0,30
22/03/2023 07:00,58,51,7,52,42,10,62,42,20,0,0,0,49,49,0,12,12,0,10,10,0,312,63,249,0,,22,0,22,82,0,82
22/03/2023 08:00,119,103,16,68,55,13,102,74,28,0,0,0,74,74,0,56,56,0,4,4,0,629,111,518,0,,57,0,57,218,0,218
22/03/2023 09:00,38,29,9,37,21,16,59,33,26,0,0,0,36,36,0,14,14,0,0,0,0,228,42,186,0,,31,0,31,144,0,144
22/03/2023 10:00,15,10,5,13,7,6,27,7,20,0,0,0,12,12,0,11,11,0,0,0,0,80,21,59,0,,27,1,26,66,0,66
22/03/2023 11:00,14,9,5,32,13,19,45,22,23,0,0,0,13,13,0,8,8,0,1,1,0,87,25,62,0,,35,1,34,52,0,52
22/03/2023 12:00,23,11,12,37,15,22,47,19,28,0,0,0,5,5,0,14,14,0,1,1,0,111,50,61,0,,64,1,63,79,1,78
22/03/2023 13:00,21,13,8,27,11,16,37,9,28,0,0,0,5,5,0,25,25,0,7,7,0,126,52,74,0,,95,1,94,90,1,89
22/03/2023 14:00,16,2,14,20,9,11,28,11,17,0,0,0,9,9,0,17,17,0,10,10,0,101,45,56,0,,77,0,77,52,0,52
22/03/2023 15:00,24,14,10,21,8,13,33,11,22,0,0,0,4,4,0,39,39,0,21,21,0,131,84,47,0,,67,0,67,63,0,63
22/03/2023 16:00,39,14,25,48,19,29,62,19,43,0,0,0,8,8,0,27,27,0,17,17,0,230,153,77,0,,121,0,121,64,1,63
22/03/2023 17:00,67,21,46,96,23,73,134,28,106,0,0,0,4,4,0,43,43,0,17,17,0,387,272,115,0,,209,1,208,98,1,97
22/03/2023 18:00,44,12,32,69,22,47,115,21,94,0,0,0,5,5,0,26,26,0,19,19,0,352,210,142,0,,177,0,177,115,1,114
22/03/2023 19:00,24,3,21,31,8,23,48,13,35,0,0,0,3,3,0,8,8,0,8,8,0,183,107,76,0,,92,0,92,79,1,78
22/03/2023 20:00,12,5,7,11,5,6,15,8,7,0,0,0,6,6,0,13,13,0,8,8,0,144,90,54,0,,86,1,85,63,1,62
22/03/2023 21:00,4,0,4,11,5,6,19,4,15,0,0,0,3,3,0,10,10,0,2,2,0,84,59,25,0,,55,0,55,47,0,47
22/03/2023 22:00,5,1,4,9,3,6,13,2,11,0,0,0,2,2,0,7,7,0,1,1,0,126,75,51,0,,63,0,63,33,0,33
22/03/2023 23:00,4,2,2,2,1,1,8,0,8,0,0,0,1,1,0,2,2,0,1,1,0,46,29,17,0,,24,0,24,21,0,21
23/03/2023 00:00,0,0,0,0,0,0,1,0,1,0,0,0,2,2,0,2,2,0,0,0,0,21,20,1,0,,16,0,16,7,0,7
23/03/2023 01:00,0,0,0,4,2,2,3,2,1,0,0,0,0,0,0,0,0,0,0,0,0,2,2,0,0,,3,0,3,1,0,1
23/03/2023 02:00,0,0,0,0,0,0,0,0,0,0,0,0,0,0,0,0,0,0,1,1,0,1,1,0,0,,5,0,5,2,0,2
23/03/2023 03:00,0,0,0,1,1,0,0,0,0,0,0,0,0,0,0,0,0,0,1,1,0,4,3,1,0,,7,0,7,2,0,2
23/03/2023 04:00,2,2,0,1,1,0,3,0,3,0,0,0,0,0,0,1,1,0,1,1,0,5,1,4,0,,1,0,1,2,0,2
23/03/2023 05:00,1,1,0,10,8,2,7,5,2,0,0,0,3,3,0,0,0,0,0,0,0,35,3,32,0,,6,0,6,3,0,3
23/03/2023 06:00,10,8,2,22,18,4,25,21,4,0,0,0,18,18,0,8,8,0,2,2,0,110,25,85,0,,10,0,10,34,0,34
23/03/2023 07:00,52,42,10,57,48,9,72,55,17,0,0,0,31,31,0,16,16,0,9,9,0,308,59,249,0,,24,0,24,82,0,82
23/03/2023 08:00,119,103,16,84,62,22,113,85,28,0,0,0,70,70,0,56,56,0,53,53,0,643,93,550,0,,54,0,54,208,0,208
23/03/2023 09:00,54,41,13,39,22,17,52,31,21,0,0,0,46,46,0,16,16,0,20,20,0,278,48,230,0,,32,0,32,145,0,145
23/03/2023 10:00,12,11,1,41,17,24,48,14,34,0,0,0,15,15,0,13,13,0,10,10,0,91,24,67,0,,25,0,25,72,0,72
23/03/2023 11:00,16,11,5,46,26,20,83,40,43,0,0,0,8,8,0,12,12,0,7,7,0,85,28,57,0,,32,0,32,74,0,74
23/03/2023 12:00,24,16,8,29,13,16,41,17,24,0,0,0,5,5,0,15,15,0,3,3,0,84,30,54,0,,45,0,45,92,1,91
23/03/2023 13:00,17,12,5,20,11,9,33,15,18,0,0,0,8,8,0,17,17,0,10,10,0,127,50,77,0,,85,0,85,93,1,92
23/03/2023 14:00,19,11,8,26,10,16,38,12,26,0,0,0,4,4,0,22,22,0,17,17,0,114,53,61,0,,68,0,68,53,0,53
23/03/2023 15:00,30,10,20,41,17,24,44,14,30,0,0,0,12,12,0,41,41,0,19,19,0,143,79,64,0,,70,0,70,76,0,76
23/03/2023 16:00,29,10,19,42,14,28,54,17,37,0,0,0,12,12,0,35,35,0,12,12,0,218,142,76,0,,120,0,120,66,1,65
23/03/2023 17:00,54,10,44,74,14,60,116,25,91,0,0,0,7,7,0,34,34,0,30,30,0,386,287,99,0,,204,1,203,104,0,104
23/03/2023 18:00,54,22,32,80,22,58,123,23,100,0,0,0,5,5,0,33,33,0,25,25,0,327,211,116,0,,201,0,201,109,1,108
23/03/2023 19:00,23,13,10,40,12,28,60,20,40,0,0,0,3,3,0,21,21,0,12,12,0,208,115,93,0,,128,1,127,81,0,81
23/03/2023 20:00,11,4,7,17,8,9,28,11,17,0,0,0,0,0,0,17,17,0,3,3,0,149,90,59,0,,86,0,86,64,0,64
23/03/2023 21:00,11,4,7,6,3,3,20,5,15,0,0,0,1,1,0,10,10,0,7,7,0,84,59,25,0,,61,0,61,38,0,38
23/03/2023 22:00,13,9,4,4,2,2,9,3,6,0,0,0,2,2,0,7,7,0,5,5,0,59,41,18,0,,43,1,42,40,0,40
23/03/2023 23:00,7,3,4,3,0,3,6,0,6,0,0,0,0,0,0,5,5,0,1,1,0,40,23,17,0,,37,0,37,21,0,21
24/03/2023 00:00,2,1,1,1,0,1,3,0,3,0,0,0,2,2,0,1,1,0,1,1,0,30,22,8,0,,22,0,22,11,0,11
24/03/2023 01:00,0,0,0,2,2,0,3,1,2,0,0,0,1,1,0,0,0,0,1,1,0,8,8,0,0,,4,0,4,1,0,1
24/03/2023 02:00,0,0,0,0,0,0,1,0,1,0,0,0,1,1,0,0,0,0,0,0,0,3,2,1,0,,1,0,1,2,0,2
24/03/2023 03:00,0,0,0,0,0,0,0,0,0,0,0,0,1,0,1,0,0,0,0,0,0,5,4,1,0,,6,0,6,3,0,3
24/03/2023 04:00,1,1,0,2,2,0,1,1,0,0,0,0,1,1,0,0,0,0,0,0,0,6,2,4,0,,2,0,2,0,0,0
24/03/2023 05:00,1,1,0,5,4,1,6,3,3,0,0,0,3,3,0,1,1,0,0,0,0,28,3,25,0,,2,0,2,10,0,10
24/03/2023 06:00,11,11,0,14,11,3,19,14,5,0,0,0,7,7,0,7,7,0,1,1,0,104,20,84,0,,9,0,9,24,0,24
24/03/2023 07:00,27,23,4,28,22,6,49,29,20,0,0,0,21,21,0,12,12,0,12,12,0,210,55,155,0,,29,0,29,58,0,58
24/03/2023 08:00,55,46,9,61,43,18,73,53,20,0,0,0,18,18,0,41,41,0,63,63,0,403,67,336,0,,44,1,43,136,0,136
24/03/2023 09:00,30,22,8,37,23,14,47,26,21,0,0,0,15,15,0,10,10,0,2,2,0,170,38,132,0,,29,0,29,105,0,105
24/03/2023 10:00,11,8,3,40,22,18,45,20,25,0,0,0,8,8,0,6,6,0,1,1,0,84,18,66,0,,33,0,33,60,0,60
24/03/2023 11:00,15,7,8,38,20,18,42,13,29,0,0,0,7,7,0,11,11,0,6,6,0,92,27,65,0,,41,0,41,55,0,55
24/03/2023 12:00,21,10,11,26,9,17,35,10,25,0,0,0,6,6,0,15,15,0,1,1,0,111,45,66,0,,58,0,58,81,0,81
24/03/2023 13:00,14,5,9,22,6,16,41,14,27,0,0,0,6,6,0,25,25,0,2,2,0,122,53,69,0,,90,0,90,99,0,99
24/03/2023 14:00,14,8,6,18,7,11,24,11,13,0,0,0,2,1,1,15,15,0,3,3,0,108,48,60,0,,61,0,61,67,0,67
24/03/2023 15:00,19,9,10,23,9,14,31,11,20,0,0,0,4,4,0,23,23,0,5,5,0,139,74,65,0,,80,0,80,64,0,64
24/03/2023 16:00,19,8,11,29,7,22,41,8,33,0,0,0,1,1,0,23,23,0,8,8,0,185,114,71,0,,103,1,102,85,1,84
24/03/2023 17:00,41,15,26,50,9,41,62,12,50,0,0,0,7,7,0,25,25,0,2,2,0,252,171,81,0,,154,1,153,105,0,105
24/03/2023 18:00,26,7,19,28,6,22,48,9,39,0,0,0,4,4,0,14,14,0,0,0,0,222,133,89,0,,114,1,113,107,0,107
24/03/2023 19:00,13,6,7,22,8,14,21,8,13,0,0,0,8,8,0,14,14,0,0,0,0,131,73,58,0,,73,0,73,88,2,86
24/03/2023 20:00,6,3,3,6,2,4,8,1,7,0,0,0,4,4,0,9,9,0,1,1,0,86,43,43,0,,78,0,78,78,1,77
24/03/2023 21:00,14,7,7,2,0,2,9,2,7,0,0,0,4,4,0,7,7,0,2,2,0,85,54,31,0,,46,1,45,63,1,62
24/03/2023 22:00,6,4,2,3,0,3,5,0,5,0,0,0,1,0,1,6,6,0,1,1,0,61,32,29,0,,35,0,35,39,0,39
24/03/2023 23:00,5,3,2,3,1,2,6,2,4,0,0,0,3,3,0,2,2,0,0,0,0,38,31,7,0,,36,0,36,21,0,21
25/03/2023 00:00,3,0,3,2,1,1,7,2,5,0,0,0,0,0,0,2,2,0,4,4,0,29,17,12,0,,25,0,25,8,0,8
25/03/2023 01:00,1,0,1,4,2,2,3,2,1,0,0,0,1,1,0,2,2,0,1,1,0,12,8,4,0,,4,0,4,0,0,0
25/03/2023 02:00,0,0,0,0,0,0,1,0,1,0,0,0,1,1,0,0,0,0,0,0,0,8,7,1,0,,9,0,9,4,0,4
25/03/2023 03:00,1,0,1,0,0,0,0,0,0,0,0,0,1,1,0,1,1,0,0,0,0,10,9,1,0,,8,0,8,6,0,6
25/03/2023 04:00,2,0,2,0,0,0,0,0,0,0,0,0,0,0,0,0,0,0,0,0,0,9,6,3,0,,7,0,7,2,0,2
25/03/2023 05:00,1,1,0,0,0,0,1,0,1,0,0,0,0,0,0,1,1,0,1,1,0,10,2,8,0,,1,0,1,4,0,4
25/03/2023 06:00,3,1,2,8,5,3,7,5,2,0,0,0,7,7,0,3,3,0,1,1,0,23,3,20,0,,4,0,4,11,0,11
25/03/2023 07:00,9,5,4,32,9,23,38,10,28,0,0,0,11,11,0,3,3,0,6,6,0,58,19,39,0,,13,0,13,16,0,16
25/03/2023 08:00,6,6,0,63,28,35,62,33,29,0,0,0,15,14,1,5,5,0,0,0,0,58,14,44,0,,22,1,21,43,1,42
25/03/2023 09:00,15,10,5,107,46,61,114,48,66,0,0,0,17,17,0,10,10,0,0,0,0,109,32,77,0,,27,0,27,60,0,60
25/03/2023 10:00,11,6,5,112,41,71,100,37,63,0,0,0,11,11,0,13,13,0,0,0,0,84,34,50,0,,37,0,37,61,0,61
25/03/2023 11:00,7,4,3,109,59,50,127,44,83,0,0,0,2,2,0,14,14,0,0,0,0,108,40,68,0,,52,0,52,63,0,63
25/03/2023 12:00,17,10,7,119,66,53,146,73,73,0,0,0,4,3,1,10,10,0,0,0,0,132,60,72,0,,60,0,60,75,2,73
25/03/2023 13:00,23,12,11,93,53,40,141,77,64,0,0,0,3,3,0,10,10,0,0,0,0,97,38,59,0,,67,0,67,112,1,111
25/03/2023 14:00,10,6,4,86,41,45,101,52,49,0,0,0,3,3,0,15,15,0,0,0,0,95,37,58,0,,47,0,47,76,0,76
25/03/2023 15:00,15,10,5,65,39,26,75,35,40,0,0,0,13,13,0,14,14,0,0,0,0,95,41,54,0,,71,0,71,74,1,73
25/03/2023 16:00,13,7,6,66,27,39,78,34,44,0,0,0,7,7,0,8,8,0,0,0,0,99,40,59,0,,74,1,73,66,0,66
25/03/2023 17:00,13,8,5,57,35,22,81,45,36,0,0,0,7,7,0,14,14,0,0,0,0,103,43,60,0,,61,0,61,83,0,83
25/03/2023 18:00,14,8,6,39,23,16,52,33,19,0,0,0,2,2,0,18,18,0,0,0,0,96,50,46,0,,83,0,83,86,1,85
25/03/2023 19:00,10,5,5,16,9,7,14,8,6,0,0,0,5,5,0,9,9,0,0,0,0,100,47,53,0,,55,0,55,71,0,71
25/03/2023 20:00,9,5,4,5,3,2,17,6,11,0,0,0,7,7,0,5,5,0,0,0,0,90,43,47,0,,54,0,54,80,1,79
25/03/2023 21:00,12,9,3,10,4,6,12,6,6,0,0,0,3,3,0,9,9,0,0,0,0,45,23,22,0,,42,1,41,41,0,41
25/03/2023 22:00,11,6,5,5,5,0,15,6,9,0,0,0,4,4,0,4,4,0,0,0,0,50,27,23,0,,18,0,18,30,0,30
25/03/2023 23:00,5,3,2,5,3,2,5,1,4,0,0,0,3,3,0,0,0,0,0,0,0,38,27,11,0,,24,0,24,19,0,19
26/03/2023 00:00,4,1,3,1,1,0,5,3,2,0,0,0,0,0,0,1,1,0,0,0,0,23,14,9,0,,24,0,24,16,0,16
26/03/2023 02:00,2,1,1,0,0,0,1,0,1,0,0,0,1,1,0,1,1,0,0,0,0,9,8,1,0,,8,0,8,0,0,0
26/03/2023 03:00,0,0,0,0,0,0,0,0,0,0,0,0,0,0,0,0,0,0,0,0,0,12,7,5,0,,14,0,14,3,0,3
26/03/2023 04:00,1,1,0,0,0,0,1,0,1,0,0,0,1,1,0,0,0,0,0,0,0,11,8,3,0,,13,0,13,6,0,6
26/03/2023 05:00,2,1,1,1,0,1,2,0,2,0,0,0,0,0,0,1,1,0,0,0,0,13,10,3,0,,6,0,6,3,0,3
26/03/2023 06:00,3,1,2,2,1,1,6,4,2,0,0,0,1,1,0,2,2,0,1,1,0,22,3,19,0,,8,0,8,7,0,7
26/03/2023 07:00,4,4,0,20,7,13,19,9,10,0,0,0,9,9,0,1,1,0,2,2,0,37,9,28,0,,6,0,6,4,0,4
26/03/2023 08:00,5,4,1,42,20,22,51,19,32,0,0,0,6,6,0,5,5,0,0,0,0,34,11,23,0,,8,0,8,11,0,11
26/03/2023 09:00,2,2,0,55,24,31,59,29,30,0,0,0,8,8,0,7,7,0,0,0,0,37,8,29,0,,12,0,12,19,0,19
26/03/2023 10:00,10,7,3,93,38,55,106,31,75,0,0,0,10,10,0,9,9,0,0,0,0,59,20,39,0,,20,0,20,37,1,36
26/03/2023 11:00,7,3,4,83,42,41,90,37,53,0,0,0,6,6,0,10,10,0,0,0,0,77,26,51,0,,24,0,24,31,0,31
26/03/2023 12:00,6,2,4,63,29,34,67,31,36,0,0,0,6,6,0,16,16,0,0,0,0,80,32,48,0,,46,0,46,44,1,43
26/03/2023 13:00,9,2,7,63,38,25,69,44,25,0,0,0,2,2,0,10,10,0,0,0,0,87,37,50,0,,48,0,48,52,0,52
26/03/2023 14:00,15,9,6,55,29,26,76,37,39,0,0,0,3,3,0,9,9,0,0,0,0,76,33,43,0,,44,0,44,52,1,51
26/03/2023 15:00,7,4,3,69,36,33,83,43,40,0,0,0,3,3,0,2,2,0,0,0,0,70,33,37,0,,44,0,44,58,0,58
26/03/2023 16:00,11,3,8,59,30,29,87,46,41,0,0,0,7,7,0,12,12,0,0,0,0,100,38,62,0,,51,0,51,53,1,52
26/03/2023 17:00,8,1,7,47,22,25,63,33,30,0,0,0,3,3,0,6,6,0,0,0,0,81,36,45,0,,52,0,52,68,1,67
26/03/2023 18:00,19,14,5,37,22,15,46,25,21,0,0,0,13,13,0,5,5,0,0,0,0,98,48,50,0,,64,0,64,79,0,79
26/03/2023 19:00,12,6,6,14,8,6,15,9,6,0,0,0,1,1,0,11,11,0,0,0,0,78,46,32,0,,65,0,65,75,0,75
26/03/2023 20:00,12,9,3,8,4,4,14,7,7,0,0,0,5,5,0,6,6,0,0,0,0,91,52,39,0,,44,0,44,70,1,69
26/03/2023 21:00,6,1,5,4,2,2,13,4,9,0,0,0,4,4,0,6,6,0,0,0,0,61,36,25,0,,45,0,45,28,0,28
26/03/2023 22:00,8,5,3,4,3,1,3,0,3,0,0,0,3,3,0,1,1,0,0,0,0,40,25,15,0,,25,0,25,28,0,28
26/03/2023 23:00,4,3,1,1,0,1,1,0,1,0,0,0,4,4,0,1,1,0,0,0,0,23,14,9,0,,19,0,19,19,0,19
27/03/2023 00:00,2,2,0,1,1,0,5,1,4,0,0,0,1,1,0,0,0,0,0,0,0,16,9,7,0,,19,1,18,5,0,5
27/03/2023 01:00,0,0,0,1,1,0,0,0,0,0,0,0,0,0,0,0,0,0,0,0,0,7,4,3,0,,0,0,0,0,0,0
27/03/2023 02:00,1,1,0,0,0,0,0,0,0,0,0,0,1,1,0,0,0,0,0,0,0,5,4,1,0,,6,0,6,0,0,0
27/03/2023 03:00,0,0,0,0,0,0,0,0,0,0,0,0,0,0,0,0,0,0,0,0,0,2,1,1,0,,1,0,1,0,0,0
27/03/2023 04:00,1,0,1,1,1,0,0,0,0,0,0,0,1,1,0,0,0,0,0,0,0,4,0,4,0,,2,0,2,1,0,1
27/03/2023 05:00,1,1,0,4,4,0,6,4,2,0,0,0,3,3,0,2,2,0,0,0,0,24,4,20,0,,2,0,2,9,0,9
27/03/2023 06:00,9,8,1,12,9,3,15,15,0,0,0,0,11,11,0,6,6,0,0,0,0,108,22,86,0,,9,0,9,17,0,17
27/03/2023 07:00,31,27,4,54,40,14,64,50,14,0,0,0,20,20,0,18,18,0,1,1,0,254,52,202,0,,30,0,30,59,1,58
27/03/2023 08:00,94,86,8,74,62,12,100,79,21,0,0,0,46,46,0,41,41,0,37,37,0,475,81,394,0,,45,0,45,159,0,159
27/03/2023 09:00,34,28,6,45,28,17,60,36,24,0,0,0,37,37,0,13,13,0,0,0,0,197,37,160,0,,33,0,33,129,1,128
27/03/2023 10:00,12,9,3,46,23,23,56,28,28,0,0,0,18,18,0,8,8,0,3,3,0,23,23,0,0,,21,0,21,65,1,64
27/03/2023 11:00,7,6,1,56,26,30,57,21,36,0,0,0,15,15,0,7,7,0,2,2,0,34,32,2,0,,37,0,37,57,0,57
27/03/2023 12:00,14,9,5,54,29,25,66,31,35,0,0,0,21,21,0,13,13,0,1,1,0,117,38,79,0,,57,0,57,80,0,80
27/03/2023 13:00,15,8,7,66,29,37,73,30,43,0,0,0,21,21,0,14,14,0,0,0,0,119,45,74,0,,85,1,84,74,0,74
27/03/2023 14:00,14,4,10,46,20,26,55,23,32,0,0,0,5,5,0,24,24,0,1,1,0,104,64,40,0,,74,0,74,71,1,70
27/03/2023 15:00,21,7,14,60,26,34,53,23,30,0,0,0,8,8,0,47,47,0,0,0,0,129,76,53,0,,90,1,89,73,0,73
27/03/2023 16:00,25,10,15,50,19,31,76,27,49,0,0,0,5,5,0,42,42,0,0,0,0,217,148,69,0,,110,0,110,72,0,72
27/03/2023 17:00,60,22,38,81,16,65,112,26,86,0,0,0,10,10,0,39,39,0,0,0,0,404,274,130,0,,200,1,199,96,0,96
27/03/2023 18:00,34,13,21,73,32,41,102,31,71,0,0,0,12,12,0,26,26,0,0,0,0,320,165,155,0,,166,0,166,113,0,113
27/03/2023 19:00,16,6,10,42,16,26,54,23,31,0,0,0,3,3,0,20,20,0,0,0,0,174,111,63,0,,124,0,124,59,1,58
27/03/2023 20:00,12,6,6,16,7,9,17,8,9,0,0,0,0,0,0,13,13,0,0,0,0,119,73,46,0,,88,1,87,42,1,41
27/03/2023 21:00,8,4,4,8,3,5,16,5,11,0,0,0,3,3,0,9,9,0,0,0,0,89,60,29,0,,59,0,59,44,0,44
27/03/2023 22:00,11,4,7,5,3,2,14,4,10,0,0,0,2,2,0,7,7,0,0,0,0,131,105,26,0,,38,0,38,28,0,28
27/03/2023 23:00,4,2,2,3,2,1,5,1,4,0,0,0,1,1,0,2,2,0,0,0,0,67,30,37,0,,19,0,19,11,0,11
28/03/2023 00:00,3,1,2,1,0,1,4,0,4,0,0,0,0,0,0,0,0,0,0,0,0,21,19,2,0,,11,0,11,9,0,9
28/03/2023 01:00,2,2,0,2,2,0,2,2,0,0,0,0,0,0,0,0,0,0,0,0,0,8,6,2,0,,2,0,2,1,0,1
28/03/2023 02:00,2,1,1,0,0,0,0,0,0,0,0,0,0,0,0,0,0,0,0,0,0,2,2,0,0,,6,0,6,2,0,2
28/03/2023 03:00,0,0,0,0,0,0,0,0,0,0,0,0,0,0,0,0,0,0,0,0,0,0,0,0,0,,3,0,3,1,0,1
28/03/2023 04:00,0,0,0,0,0,0,0,0,0,0,0,0,0,0,0,0,0,0,0,0,0,6,0,6,0,,1,0,1,2,0,2
28/03/2023 05:00,0,0,0,0,0,0,1,1,0,0,0,0,3,3,0,3,3,0,0,0,0,24,2,22,0,,4,0,4,5,0,5
28/03/2023 06:00,10,8,2,12,10,2,15,13,2,0,0,0,22,21,1,4,4,0,0,0,0,121,31,90,0,,12,0,12,23,0,23
28/03/2023 07:00,35,30,5,33,29,4,48,39,9,0,0,0,22,22,0,19,19,0,0,0,0,300,62,238,0,,27,0,27,73,1,72
28/03/2023 08:00,87,78,9,54,45,9,83,66,17,0,0,0,41,40,1,37,37,0,4,4,0,627,70,557,0,,47,0,47,189,0,189
28/03/2023 09:00,52,47,5,28,21,7,37,30,7,0,0,0,32,32,0,13,13,0,4,4,0,260,52,208,0,,28,0,28,168,0,168
28/03/2023 10:00,18,15,3,50,24,26,53,21,32,0,0,0,17,17,0,8,8,0,6,6,0,87,21,66,0,,26,0,26,56,1,55
28/03/2023 11:00,8,7,1,25,12,13,34,17,17,0,0,0,10,10,0,9,9,0,8,8,0,80,26,54,0,,19,0,19,51,0,51
28/03/2023 12:00,9,8,1,37,16,21,50,26,24,0,0,0,4,3,1,14,14,0,8,8,0,96,33,63,0,,52,0,52,78,0,78
28/03/2023 13:00,15,5,10,50,23,27,47,19,28,0,0,0,0,0,0,14,14,0,12,12,0,119,53,66,0,,74,0,74,74,1,73
28/03/2023 14:00,13,6,7,35,17,18,40,23,17,0,0,0,4,4,0,22,22,0,16,16,0,90,44,46,0,,51,1,50,64,1,63
28/03/2023 15:00,20,8,12,36,16,20,48,16,32,0,0,0,12,12,0,24,24,0,11,11,0,138,85,53,0,,63,0,63,63,2,61
28/03/2023 16:00,29,9,20,51,18,33,69,22,47,0,0,0,17,17,0,32,32,0,25,25,0,228,131,97,0,,113,2,111,69,1,68
28/03/2023 17:00,63,12,51,91,22,69,131,31,100,0,0,0,7,7,0,34,34,0,17,17,0,398,279,119,0,,207,2,205,86,0,86
28/03/2023 18:00,56,14,42,118,46,72,139,34,105,0,0,0,11,11,0,40,40,0,17,17,0,341,236,105,0,,221,1,220,113,1,112
28/03/2023 19:00,24,10,14,58,32,26,79,41,38,0,0,0,10,10,0,22,22,0,12,12,0,202,125,77,0,,142,1,141,79,0,79
28/03/2023 20:00,16,9,7,24,11,13,41,17,24,0,0,0,6,6,0,12,12,0,8,8,0,138,91,47,0,,114,0,114,73,0,73
28/03/2023 21:00,7,3,4,21,9,12,25,10,15,0,0,0,5,5,0,6,6,0,1,1,0,83,51,32,0,,54,1,53,58,1,57
28/03/2023 22:00,6,2,4,8,4,4,9,3,6,0,0,0,7,7,0,3,3,0,0,0,0,55,42,13,0,,35,0,35,28,0,28
28/03/2023 23:00,6,1,5,1,0,1,3,0,3,0,0,0,1,1,0,4,4,0,0,0,0,34,24,10,0,,32,0,32,28,0,28
29/03/2023 00:00,1,0,1,0,0,0,2,1,1,0,0,0,1,1,0,4,4,0,0,0,0,17,14,3,0,,17,0,17,12,0,12
29/03/2023 01:00,1,0,1,2,2,0,2,1,1,0,0,0,0,0,0,0,0,0,0,0,0,6,3,3,0,,4,0,4,1,0,1
29/03/2023 02:00,1,0,1,0,0,0,0,0,0,0,0,0,1,1,0,0,0,0,0,0,0,6,6,0,0,,4,0,4,3,0,3
29/03/2023 03:00,0,0,0,0,0,0,1,0,1,0,0,0,0,0,0,0,0,0,0,0,0,3,2,1,0,,2,0,2,3,0,3
29/03/2023 04:00,3,1,2,1,1,0,1,0,1,0,0,0,0,0,0,0,0,0,0,0,0,2,0,2,0,,3,0,3,4,0,4
29/03/2023 05:00,2,2,0,2,1,1,5,2,3,0,0,0,8,8,0,3,3,0,0,0,0,37,6,31,0,,2,0,2,12,0,12
29/03/2023 06:00,11,9,2,15,11,4,24,17,7,0,0,0,13,13,0,7,7,0,0,0,0,122,26,96,0,,12,0,12,31,0,31
29/03/2023 07:00,53,46,7,51,40,11,69,51,18,0,0,0,52,52,0,15,15,0,0,0,0,312,64,248,0,,26,0,26,87,0,87
29/03/2023 08:00,105,96,9,77,60,17,97,75,22,0,0,0,79,79,0,50,50,0,0,0,0,675,103,572,0,,64,0,64,164,1,163
29/03/2023 09:00,45,34,11,33,23,10,45,32,13,0,0,0,36,36,0,19,19,0,0,0,0,301,57,244,0,,38,0,38,153,1,152
29/03/2023 10:00,20,16,4,34,21,13,35,12,23,0,0,0,14,14,0,12,12,0,0,0,0,87,20,67,0,,22,1,21,63,0,63
29/03/2023 11:00,9,4,5,11,4,7,7,4,3,0,0,0,8,8,0,5,5,0,0,0,0,72,30,42,0,,28,1,27,48,0,48
29/03/2023 12:00,13,8,5,12,7,5,16,9,7,0,0,0,16,16,0,10,10,0,0,0,0,93,36,57,0,,59,0,59,55,0,55
29/03/2023 13:00,18,10,8,23,11,12,29,9,20,0,0,0,10,10,0,27,27,0,0,0,0,119,58,61,0,,80,0,80,72,0,72
29/03/2023 14:00,10,3,7,26,5,21,45,12,33,0,0,0,5,5,0,17,17,0,0,0,0,121,41,80,0,,63,0,63,71,0,71
29/03/2023 15:00,22,9,13,31,13,18,44,17,27,0,0,0,13,13,0,37,37,0,0,0,0,141,79,62,0,,67,1,66,68,0,68
29/03/2023 16:00,35,12,23,49,12,37,72,17,55,0,0,0,8,8,0,37,37,0,0,0,0,247,170,77,0,,129,1,128,72,0,72
29/03/2023 17:00,78,21,57,70,20,50,132,31,101,0,0,0,6,6,0,46,46,0,0,0,0,436,316,120,0,,208,0,208,102,0,102
29/03/2023 18:00,48,21,27,67,20,47,134,28,106,0,0,0,11,11,0,34,34,0,0,0,0,340,229,111,0,,185,0,185,131,0,131
29/03/2023 19:00,21,5,16,56,29,27,92,33,59,0,0,0,4,4,0,22,22,0,0,0,0,207,128,79,0,,112,0,112,83,0,83
29/03/2023 20:00,19,5,14,44,24,20,59,26,33,0,0,0,5,5,0,12,12,0,0,0,0,179,111,68,0,,102,0,102,84,0,84
29/03/2023 21:00,11,5,6,10,5,5,19,6,13,0,0,0,5,5,0,10,10,0,0,0,0,123,81,42,0,,74,0,74,75,0,75
29/03/2023 22:00,10,7,3,7,4,3,17,5,12,0,0,0,3,3,0,7,7,0,1,1,0,59,36,23,0,,56,1,55,44,0,44
29/03/2023 23:00,4,2,2,7,1,6,5,0,5,0,0,0,2,2,0,2,2,0,0,0,0,38,29,9,0,,34,0,34,27,0,27
30/03/2023 00:00,2,2,0,0,0,0,0,0,0,0,0,0,0,0,0,1,1,0,0,0,0,15,12,3,0,,23,0,23,11,1,10
30/03/2023 01:00,0,0,0,2,2,0,3,2,1,0,0,0,0,0,0,0,0,0,0,0,0,10,7,3,0,,1,0,1,0,0,0
30/03/2023 02:00,0,0,0,0,0,0,4,1,3,0,0,0,0,0,0,0,0,0,0,0,0,0,0,0,0,,3,0,3,0,0,0
30/03/2023 03:00,1,0,1,0,0,0,0,0,0,0,0,0,0,0,0,0,0,0,0,0,0,5,2,3,0,,8,1,7,4,0,4
30/03/2023 04:00,1,1,0,1,1,0,3,0,3,0,0,0,0,0,0,0,0,0,0,0,0,2,0,2,0,,0,0,0,1,0,1
30/03/2023 05:00,2,2,0,6,3,3,7,3,4,0,0,0,2,2,0,2,2,0,0,0,0,38,8,30,0,,3,0,3,5,0,5
30/03/2023 06:00,9,8,1,20,17,3,20,17,3,0,0,0,17,17,0,4,4,0,0,0,0,115,22,93,0,,18,0,18,27,0,27
30/03/2023 07:00,42,36,6,53,47,6,70,57,13,0,0,0,20,20,0,19,19,0,0,0,0,306,65,241,0,,28,2,26,87,1,86
30/03/2023 08:00,108,95,13,105,78,27,133,93,40,0,0,0,28,28,0,41,41,0,0,0,0,662,108,554,0,,50,0,50,194,0,194
30/03/2023 09:00,47,42,5,60,43,17,77,54,23,0,0,0,23,23,0,24,24,0,0,0,0,290,39,251,0,,32,0,32,134,0,134
30/03/2023 10:00,18,15,3,49,19,30,50,17,33,0,0,0,24,24,0,14,14,0,0,0,0,100,29,71,0,,27,0,27,67,0,67
30/03/2023 11:00,8,3,5,42,19,23,44,18,26,0,0,0,13,11,2,15,15,0,0,0,0,82,29,53,0,,24,1,23,80,0,80
30/03/2023 12:00,16,8,8,61,38,23,62,33,29,0,0,0,14,13,1,12,12,0,0,0,0,116,43,73,0,,65,1,64,85,0,85
30/03/2023 13:00,19,9,10,49,26,23,55,22,33,0,0,0,10,10,0,20,20,0,3,3,0,133,71,62,0,,79,0,79,88,1,87
30/03/2023 14:00,14,4,10,38,16,22,47,17,30,0,0,0,11,11,0,19,19,0,1,1,0,108,55,53,0,,55,0,55,57,0,57
30/03/2023 15:00,15,9,6,40,13,27,52,16,36,0,0,0,9,9,0,45,45,0,8,8,0,143,83,60,0,,80,1,79,83,0,83
30/03/2023 16:00,31,13,18,58,15,43,84,21,63,0,0,0,12,12,0,39,39,0,0,0,0,237,143,94,0,,118,1,117,94,0,94
30/03/2023 17:00,82,20,62,126,37,89,189,51,138,0,0,0,4,4,0,39,39,0,0,0,0,394,271,123,0,,215,3,212,105,1,104
30/03/2023 18:00,40,11,29,141,54,87,178,56,122,0,0,0,8,7,1,41,41,0,0,0,0,361,230,131,0,,166,0,166,131,1,130
30/03/2023 19:00,21,6,15,65,32,33,81,40,41,0,0,0,9,9,0,19,19,0,0,0,0,182,102,80,0,,132,1,131,90,0,90
30/03/2023 20:00,13,6,7,28,11,17,48,20,28,0,0,0,9,9,0,16,16,0,0,0,0,161,101,60,0,,79,0,79,80,0,80
30/03/2023 21:00,6,1,5,10,6,4,9,2,7,0,0,0,5,5,0,10,10,0,1,1,0,103,62,41,0,,70,1,69,62,0,62
30/03/2023 22:00,4,2,2,4,1,3,4,2,2,0,0,0,2,2,0,5,5,0,0,0,0,76,54,22,0,,70,2,68,40,0,40
30/03/2023 23:00,7,4,3,5,2,3,5,0,5,0,0,0,5,5,0,2,2,0,0,0,0,47,36,11,0,,36,0,36,26,0,26
31/03/2023 00:00,0,0,0,1,0,1,1,0,1,0,0,0,2,2,0,0,0,0,1,1,0,29,21,8,0,,18,0,18,12,0,12
31/03/2023 01:00,0,0,0,2,1,1,2,2,0,0,0,0,0,0,0,2,2,0,0,0,0,12,11,1,0,,3,0,3,1,0,1
31/03/2023 02:00,1,1,0,0,0,0,0,0,0,0,0,0,1,1,0,0,0,0,0,0,0,5,3,2,0,,9,0,9,2,0,2
31/03/2023 03:00,0,0,0,0,0,0,1,0,1,0,0,0,0,0,0,0,0,0,0,0,0,6,5,1,0,,7,0,7,3,0,3
31/03/2023 04:00,0,0,0,1,1,0,1,1,0,0,0,0,2,2,0,0,0,0,0,0,0,6,1,5,0,,5,0,5,3,0,3
31/03/2023 05:00,3,2,1,4,3,1,5,4,1,0,0,0,4,4,0,1,1,0,0,0,0,32,4,28,0,,1,0,1,7,0,7
31/03/2023 06:00,10,10,0,10,6,4,9,4,5,0,0,0,23,23,0,5,5,0,0,0,0,102,21,81,0,,12,0,12,21,0,21
31/03/2023 07:00,23,20,3,35,24,11,37,28,9,0,0,0,30,30,0,14,14,0,0,0,0,188,48,140,0,,23,0,23,54,1,53
31/03/2023 08:00,59,52,7,50,35,15,68,44,24,0,0,0,48,48,0,40,40,0,2,2,0,346,54,292,0,,39,2,37,114,0,114
31/03/2023 09:00,22,18,4,28,17,11,38,23,15,0,0,0,25,25,0,5,5,0,0,0,0,183,36,147,0,,37,0,37,132,0,132
31/03/2023 10:00,13,11,2,36,19,17,44,18,26,0,0,0,8,8,0,8,8,0,0,0,0,85,28,57,0,,26,1,25,70,0,70
31/03/2023 11:00,8,6,2,35,16,19,42,21,21,0,0,0,10,9,1,9,9,0,0,0,0,87,26,61,0,,36,0,36,54,0,54
31/03/2023 12:00,22,10,12,28,14,14,38,17,21,0,0,0,9,9,0,13,13,0,0,0,0,131,52,79,0,,63,0,63,84,0,84
31/03/2023 13:00,20,8,12,30,18,12,33,16,17,0,0,0,15,15,0,40,40,0,1,1,0,101,48,53,0,,81,0,81,74,0,74
31/03/2023 14:00,5,1,4,16,6,10,28,14,14,0,0,0,11,11,0,18,18,0,0,0,0,124,61,63,0,,74,0,74,69,0,69
31/03/2023 15:00,15,5,10,24,7,17,35,12,23,0,0,0,5,5,0,31,31,0,0,0,0,145,81,64,0,,66,0,66,70,0,70
31/03/2023 16:00,24,12,12,19,5,14,24,5,19,0,0,0,6,6,0,19,19,0,0,0,0,171,95,76,0,,80,0,80,51,0,51
31/03/2023 17:00,36,13,23,36,9,27,48,14,34,0,0,0,6,6,0,17,17,0,0,0,0,207,144,63,0,,123,0,123,61,0,61
31/03/2023 18:00,23,4,19,26,3,23,36,7,29,0,0,0,13,13,0,11,11,0,0,0,0,214,131,83,0,,118,1,117,59,0,59
31/03/2023 19:00,14,3,11,16,3,13,26,7,19,0,0,0,6,6,0,5,5,0,0,0,0,124,77,47,0,,80,0,80,79,0,79
31/03/2023 20:00,11,4,7,6,2,4,16,5,11,0,0,0,1,1,0,3,3,0,0,0,0,95,51,44,0,,44,1,43,62,0,62
31/03/2023 21:00,9,3,6,1,1,0,3,1,2,0,0,0,5,5,0,5,5,0,0,0,0,54,34,20,0,,46,0,46,40,0,40
31/03/2023 22:00,4,2,2,2,2,0,9,2,7,0,0,0,3,3,0,2,2,0,1,1,0,48,28,20,0,,27,0,27,32,0,32
31/03/2023 23:00,4,2,2,3,1,2,0,0,0,0,0,0,5,5,0,2,2,0,0,0,0,36,25,11,0,,27,0,27,16,0,16
1/4/2023 0:00,2,1,1,0,0,0,5,1,4,0,0,0,1,1,0,2,2,0,0,0,0,27,21,6,0,,20,0,20,15,0,15
1/4/2023 1:00,1,1,0,3,2,1,1,1,0,0,0,0,2,2,0,1,1,0,0,0,0,15,10,5,0,,5,0,5,1,0,1
1/4/2023 2:00,2,1,1,2,0,2,2,0,2,0,0,0,0,0,0,0,0,0,0,0,0,4,2,2,0,,5,0,5,3,0,3
1/4/2023 3:00,0,0,0,0,0,0,0,0,0,0,0,0,0,0,0,0,0,0,0,0,0,6,3,3,0,,8,0,8,1,0,1
1/4/2023 4:00,0,0,0,0,0,0,0,0,0,0,0,0,1,1,0,0,0,0,0,0,0,10,6,4,0,,6,1,5,3,0,3
1/4/2023 5:00,0,0,0,1,0,1,2,1,1,0,0,0,0,0,0,1,1,0,0,0,0,5,2,3,0,,6,1,5,3,0,3
1/4/2023 6:00,0,0,0,2,2,0,5,4,1,0,0,0,3,3,0,2,2,0,0,0,0,22,5,17,0,,3,0,3,3,0,3
1/4/2023 7:00,3,2,1,4,0,4,4,0,4,0,0,0,8,8,0,3,3,0,1,1,0,28,11,17,0,,10,0,10,10,0,10
1/4/2023 8:00,3,3,0,13,8,5,19,11,8,0,0,0,8,8,0,1,1,0,0,0,0,44,14,30,0,,9,0,9,22,0,22
1/4/2023 9:00,2,2,0,21,7,14,24,10,14,0,0,0,7,6,1,5,5,0,0,0,0,54,16,38,0,,14,1,13,33,0,33
1/4/2023 10:00,7,5,2,24,10,14,31,14,17,0,0,0,4,4,0,2,2,0,1,1,0,49,11,38,0,,16,0,16,31,1,30
1/4/2023 11:00,8,6,2,21,12,9,20,15,5,0,0,0,3,3,0,5,5,0,0,0,0,68,22,46,0,,28,1,27,45,0,45
1/4/2023 12:00,8,5,3,24,11,13,41,17,24,0,0,0,1,1,0,5,5,0,0,0,0,88,32,56,0,,46,0,46,61,0,61
1/4/2023 13:00,13,8,5,46,22,24,59,26,33,0,0,0,5,5,0,5,5,0,0,0,0,87,33,54,0,,62,0,62,81,0,81
1/4/2023 14:00,16,7,9,65,25,40,78,33,45,0,0,0,12,11,1,7,7,0,0,0,0,73,40,33,0,,71,0,71,77,1,76
1/4/2023 15:00,10,5,5,79,37,42,91,40,51,0,0,0,13,12,1,17,17,0,1,1,0,74,28,46,0,,67,0,67,51,0,51
1/4/2023 16:00,12,7,5,58,39,19,69,38,31,0,0,0,13,13,0,5,5,0,0,0,0,75,30,45,0,,49,0,49,36,1,35
1/4/2023 17:00,5,2,3,29,16,13,31,18,13,0,0,0,9,9,0,7,7,0,0,0,0,81,38,43,0,,49,0,49,36,1,35
1/4/2023 18:00,11,5,6,8,2,6,13,5,8,0,0,0,7,7,0,3,3,0,0,0,0,72,42,30,0,,40,0,40,39,0,39
1/4/2023 19:00,7,1,6,5,3,2,12,7,5,0,0,0,7,7,0,5,5,0,0,0,0,78,36,42,0,,48,0,48,48,1,47
1/4/2023 20:00,10,6,4,3,0,3,6,2,4,0,0,0,3,3,0,8,8,0,0,0,0,63,27,36,0,,48,0,48,56,0,56
1/4/2023 21:00,4,3,1,3,1,2,3,2,1,0,0,0,0,0,0,1,1,0,0,0,0,58,30,28,0,,38,0,38,41,1,40
1/4/2023 22:00,7,4,3,1,0,1,3,1,2,0,0,0,2,2,0,6,6,0,0,0,0,44,30,14,0,,28,0,28,22,0,22
1/4/2023 23:00,4,3,1,1,0,1,5,2,3,0,0,0,3,3,0,2,2,0,0,0,0,36,24,12,0,,7,0,7,20,0,20
2/4/2023 0:00,2,2,0,0,0,0,6,3,3,0,0,0,0,0,0,2,2,0,0,0,0,26,15,11,0,,15,0,15,15,0,15
2/4/2023 1:00,3,2,1,2,2,0,2,2,0,0,0,0,2,2,0,1,1,0,0,0,0,22,14,8,0,,6,0,6,0,0,0
2/4/2023 2:00,1,1,0,1,0,1,0,0,0,0,0,0,0,0,0,0,0,0,0,0,0,18,12,6,0,,13,0,13,5,0,5
2/4/2023 3:00,1,1,0,0,0,0,0,0,0,0,0,0,0,0,0,0,0,0,0,0,0,10,6,4,0,,12,0,12,7,0,7
2/4/2023 4:00,0,0,0,0,0,0,1,1,0,0,0,0,0,0,0,0,0,0,0,0,0,3,0,3,0,,6,0,6,2,0,2
2/4/2023 5:00,1,0,1,3,2,1,4,2,2,0,0,0,1,1,0,0,0,0,0,0,0,10,6,4,0,,5,0,5,3,0,3
2/4/2023 6:00,4,2,2,9,3,6,7,4,3,0,0,0,2,2,0,2,2,0,0,0,0,28,8,20,0,,4,0,4,3,0,3
2/4/2023 7:00,4,4,0,26,12,14,27,13,14,0,0,0,6,6,0,1,1,0,0,0,0,37,12,25,0,,9,0,9,7,0,7
2/4/2023 8:00,3,3,0,99,37,62,102,52,50,0,0,0,5,5,0,3,3,0,0,0,0,37,15,22,0,,6,0,6,16,0,16
2/4/2023 9:00,9,7,2,114,51,63,147,59,88,0,0,0,10,10,0,8,8,0,0,0,0,61,24,37,0,,14,0,14,29,0,29
2/4/2023 10:00,13,5,8,187,73,114,214,91,123,0,0,0,17,17,0,10,10,0,0,0,0,76,17,59,0,,15,0,15,45,0,45
2/4/2023 11:00,9,4,5,204,107,97,228,109,119,0,0,0,5,5,0,12,12,0,0,0,0,91,30,61,0,,37,0,37,61,0,61
2/4/2023 12:00,19,12,7,174,93,81,207,105,102,0,0,0,2,2,0,19,19,0,1,1,0,121,50,71,0,,41,0,41,67,0,67
2/4/2023 13:00,17,7,10,144,72,72,169,83,86,0,0,0,3,2,1,15,15,0,0,0,0,101,40,61,0,,64,0,64,95,0,95
2/4/2023 14:00,13,7,6,165,84,81,208,94,114,0,0,0,3,3,0,17,17,0,0,0,0,99,38,61,0,,56,0,56,63,0,63
2/4/2023 15:00,13,4,9,133,72,61,162,88,74,0,0,0,7,7,0,20,20,0,5,5,0,99,40,59,0,,47,0,47,94,0,94
2/4/2023 16:00,7,5,2,142,77,65,190,95,95,0,0,0,11,11,0,16,16,0,2,2,0,105,44,61,0,,54,0,54,77,0,77
2/4/2023 17:00,12,5,7,81,53,28,120,75,45,0,0,0,5,5,0,9,9,0,1,1,0,100,50,50,0,,61,0,61,68,1,67
2/4/2023 18:00,13,9,4,55,30,25,94,49,45,0,0,0,11,9,2,26,26,0,0,0,0,103,46,57,0,,84,3,81,77,0,77
2/4/2023 19:00,9,5,4,34,16,18,53,27,26,0,0,0,3,3,0,10,10,0,1,1,0,102,55,47,0,,66,1,65,60,0,60
2/4/2023 20:00,6,4,2,20,13,7,33,18,15,0,0,0,1,1,0,7,7,0,1,1,0,91,41,50,0,,52,1,51,50,0,50
2/4/2023 21:00,4,1,3,13,9,4,13,7,6,0,0,0,0,0,0,6,6,0,1,1,0,54,24,30,0,,44,0,44,54,0,54
2/4/2023 22:00,3,2,1,1,0,1,9,4,5,0,0,0,5,5,0,2,2,0,0,0,0,29,15,14,0,,37,0,37,41,1,40
2/4/2023 23:00,4,4,0,3,2,1,9,3,6,0,0,0,2,2,0,3,3,0,0,0,0,25,18,7,0,,19,0,19,18,0,18
